"","Condition","X","responseId","startTime","endTime","testType","activityPoints","dfs","dfsItens","dfs01","dfs02","dfs03","dfs04","dfs05","dfs06","dfs07","dfs08","dfs09","dejectionPre2","FR01","FR04","FR03","FR10","FR02","FR06","prevention.pre","promotion.pre","dejectionPost","tense","nervous","anxious","depressed","uncertain","agitated","calm","self_conscious","quiet","unconcerned","disappointed","frustrated","sad","contented","enthusiastic","happy","balanced","dejection","cheerfulness","promotion.pos","agitation","quiescence","prevention.pos","fss","flow","flow01","flow02","flow03","flow04","flow05","flow06","flow07","flow08","gender","age","ethnicity","sexualOrientation","civilState","city","universityEducation","institucion","educationLevel","conclusion"
"1","control",6,"18379910-9df4-11eb-9b7e-0daf340a71ab",1618494713997,1618495449457,"default",6.40312423743285,3,"3,3,4,2,2,3,2,4,4",3,3,4,2,2,3,2,4,4,"4, 5, 3, 3, 4, 2",4,5,3,3,4,2,7,3.33,"4,2,2,2,4,1,5,5,5,2,1,1,1,5,2,4,5",4,2,2,2,4,1,5,5,5,2,1,1,1,5,2,4,5,1,4,2.5,2.5,4.25,3.13,3.5,"4,4,2,2,4,5,2,5",4,4,2,2,4,5,2,5,"Masculino",23,"Branco","Heterossexual","Solteiro(a)","Maceió","Sim","UFAL","Graduação",2023
"2","control",7,"4b9fd020-9e02-11eb-9b7e-0daf340a71ab",1618501325522,1618501732613,"default",7.81024967590665,4.777777778,"5,4,5,5,4,5,5,5,5",5,4,5,5,4,5,5,5,5,"4, 5, 5, 5, 5, 4",4,5,5,5,5,4,4,4.67,"5,5,7,1,4,4,3,5,5,1,1,1,1,4,4,1,1",5,5,7,1,4,4,3,5,5,1,1,1,1,4,4,1,1,1,2.5,3.25,4.33,3.5,4.42,2.625,"5,1,1,5,1,1,3,4",5,1,1,5,1,1,3,4,"Masculino",22,"Pardo","Heterossexual","Solteiro(a)","maceió","Sim","unit","Graduação",2021
"5","control",15,"7ac290a0-a437-11eb-8cbb-599e427a3fce",1619183733777,1619184236905,"default",7.81024967590665,3.555555556,"3,3,4,5,3,3,5,3,3",3,3,4,5,3,3,5,3,3,"3, 4, 2, 2, 4, 4",3,4,2,2,4,4,6,2.33,"5,3,5,1,5,4,3,7,5,7,4,4,1,2,4,4,3",5,3,5,1,5,4,3,7,5,7,4,4,1,2,4,4,3,3,3.25,3.88,3.83,5.5,3.17,3.625,"4,5,3,3,4,3,3,4",4,5,3,3,4,3,3,4,"Masculino",54,"Pardo","Heterossexual","Casado(a)","Alfenas","Sim","UFOP","Mestrado",2021
"9","control",26,"d1fc0bc0-a848-11eb-8cbb-599e427a3fce",1619630821705,1619631258387,"default",9,2.888888889,"2,4,4,2,2,1,5,5,1",2,4,4,2,2,1,5,5,1,"4, 5, 5, 5, 5, 5",4,5,5,5,5,5,3,4.67,"5,5,5,1,6,1,5,5,5,1,3,3,1,2,4,2,4",5,5,5,1,6,1,5,5,5,1,3,3,1,2,4,2,4,2.333333333,3,3.67,3.83,4,3.92,4.625,"4,5,5,5,5,5,5,3",4,5,5,5,5,5,5,3,"Masculino",23,"Pardo","Homossexual","Solteiro(a)","CAMPO GRANDE","Sim","UFMS","Graduação",2023
"11","control",28,"da329100-aeb6-11eb-8cbb-599e427a3fce",1620337827048,1620338354837,"default",6.40312423743285,3.444444444,"4,2,4,3,4,2,4,3,5",4,2,4,3,4,2,4,3,5,"3, 5, 4, 4, 2, 3",3,5,4,4,2,3,8,3.67,"1,1,2,1,4,1,5,5,4,5,2,2,1,5,5,4,5",1,1,2,1,4,1,5,5,4,5,2,2,1,5,5,4,5,1.666666667,4.75,2.46,1.67,4.75,2.46,3.375,"3,5,3,1,4,3,3,5",3,5,3,1,4,3,3,5,"Feminino",22,"Pardo","Heterossexual","Solteiro(a)","Maceió","Sim","UFAL","Graduação",2022
"14","control",34,"c5d98fb0-b1c7-11eb-b944-15c8c1c6ce71",1620674228832,1620675578697,"default",6.40312423743285,3.444444444,"4,1,4,5,3,4,4,2,4",4,1,4,5,3,4,4,2,4,"3, 4, 4, 4, 3, 2",3,4,4,4,3,2,9,3.67,"1,1,1,1,4,1,4,4,4,5,1,1,1,1,1,1,6",1,1,1,1,4,1,4,4,4,5,1,1,1,1,1,1,6,1,2.25,3.38,1.5,4.25,2.63,3.125,"5,2,4,1,4,4,3,2",5,2,4,1,4,4,3,2,"Feminino",19,"Branco","Heterossexual","Prefiro não Responder","Maceió","Sim","UFAL","Graduação",2024
"17","control",38,"3cbe7e50-b25a-11eb-b944-15c8c1c6ce71",1620738047180,1620738541480,"default",7.14142842854285,4.111111111,"5,4,5,4,4,3,3,5,4",5,4,5,4,4,3,3,5,4,"4, 4, 4, 2, 5, 5",4,4,4,2,5,5,4,3.33,"1,1,1,1,2,1,7,7,1,1,1,1,1,5,6,4,7",1,1,1,1,2,1,7,7,1,1,1,1,1,5,6,4,7,1,5.5,1.75,1.17,4,2.58,4,"5,1,5,4,5,5,4,3",5,1,5,4,5,5,4,3,"Masculino",23,"Branco","Heterossexual","Solteiro(a)","Paranoá","Sim","Universidade de Brasilia","Graduação",2022
"19","control",46,"92d0f4f0-b834-11eb-93e6-43229aa359ae",1621381184774,1621382048968,"default",8.42614977317636,3.555555556,"4,3,4,3,3,3,3,5,4",4,3,4,3,3,3,3,5,4,"2, 4, 4, 3, 4, 4",2,4,4,3,4,4,6,3,"6,5,6,4,7,5,2,4,1,2,4,2,3,2,2,1,1",6,5,6,4,7,5,2,4,1,2,4,2,3,2,2,1,1,3,1.5,4.75,5.5,2.25,5.63,2.25,"2,3,2,5,2,1,1,2",2,3,2,5,2,1,1,2,"Feminino",23,"Negro","Prefiro não Responder","Solteiro(a)","Maceió","Sim","UFAL","Graduação",2025
"21","control",53,"fc1e63c0-dbac-11eb-916d-ef9a5fc9a834",1625280266099,1625281729259,"default",7.14142842854285,2.555555556,"3,2,4,2,2,1,2,4,3",3,2,4,2,2,1,2,4,3,"3, 4, 3, 3, 5, 4",3,4,3,3,5,4,5,3,"1,1,3,1,5,1,5,7,6,6,6,6,2,2,3,2,6",1,1,3,1,5,1,5,7,6,6,6,6,2,2,3,2,6,4.666666667,3.25,4.71,2,6,2,3.625,"4,4,4,1,5,5,4,2",4,4,4,1,5,5,4,2,"Feminino",19,"Negro","Heterossexual","Solteiro(a)","Paripueira","Sim","UFAL","Graduação",2025
"23","control",55,"4ca8d3a0-dc27-11eb-916d-ef9a5fc9a834",1625334003218,1625334563305,"default",6.40312423743285,3.222222222,"4,2,4,3,1,3,4,5,3",4,2,4,3,1,3,4,5,3,"3, 2, 4, 2, 5, 3",3,2,4,2,5,3,8,3,"1,1,2,2,3,1,4,5,3,6,2,1,1,3,4,2,4",1,1,2,2,3,1,4,5,3,6,2,1,1,3,4,2,4,1.333333333,3.25,3.04,1.67,4.5,2.58,3.875,"4,5,3,5,5,5,2,2",4,5,3,5,5,5,2,2,"Masculino",21,"Negro","Heterossexual","Solteiro(a)","Coruripe","Sim","Instituto da Computação","Graduação",2025
"24","control",57,"c2104500-df61-11eb-bf23-972ef7bdc96c",1625689144337,1625689576895,"default",9,3.666666667,"3,2,5,3,4,3,5,4,4",3,2,5,3,4,3,5,4,4,"3, 5, 3, 4, 5, 3",3,5,3,4,5,3,5,3.33,"2,2,3,2,5,1,4,4,3,2,3,2,,4,3,4,4",2,2,3,2,5,1,4,4,3,2,3,2,NA,4,3,4,4,2.5,3.75,3.38,2.5,3.25,3.63,3.25,"4,5,3,2,4,3,3,2",4,5,3,2,4,3,3,2,"Masculino",18,"Pardo","Heterossexual","Solteiro(a)","Rio Largo","Sim","UFAL","Graduação",2023
"25","control",59,"eacce390-df61-11eb-bf23-972ef7bdc96c",1625689128108,1625689604033,"default",6.40312423743285,3.666666667,"3,1,5,4,5,3,5,2,5",3,1,5,4,5,3,5,2,5,"3, 3, 3, 5, 5, 4",3,3,3,5,5,4,6,3.67,"2,2,4,2,5,4,6,6,5,5,2,1,1,7,6,6,7",2,2,4,2,5,4,6,6,5,5,2,1,1,7,6,6,7,1.333333333,6.5,1.42,3.17,5.5,2.83,4.125,"4,5,5,1,4,4,5,5",4,5,5,1,4,4,5,5,"Masculino",18,"Pardo","Heterossexual","Solteiro(a)","Maceio","Sim","UFAL","Graduação",2026
"26","control",63,"369d0020-df62-11eb-bf23-972ef7bdc96c",1625689236446,1625689724073,"default",7.81024967590665,3.444444444,"3,2,4,3,4,3,2,5,5",3,2,4,3,4,3,2,5,5,"3, 5, 4, 4, 5, 4",3,5,4,4,5,4,4,3.67,"4,2,6,1,6,6,2,4,3,3,1,1,1,6,6,6,5",4,2,6,1,6,6,2,4,3,3,1,1,1,6,6,6,5,1,5.75,1.63,4.17,3,4.58,4.125,"5,2,3,4,5,5,4,5",5,2,3,4,5,5,4,5,"Masculino",19,"Branco","Heterossexual","Solteiro(a)","Maceió","Sim","UFAL","Graduação",2025
"27","control",64,"3ee27670-df62-11eb-bf23-972ef7bdc96c",1625689186996,1625689720011,"default",6.40312423743285,3.555555556,"4,2,3,3,4,3,5,5,3",4,2,3,3,4,3,5,5,3,"2, 5, 3, 4, 4, 3",2,5,3,4,4,3,6,3,"1,1,1,1,6,1,7,6,7,6,1,1,1,6,6,6,7",1,1,1,1,6,1,7,6,7,6,1,1,1,6,6,6,7,1,6.25,1.38,1.83,6.5,1.67,4.625,"5,5,4,5,5,4,4,5",5,5,4,5,5,4,4,5,"Masculino",19,"Pardo","Heterossexual","Solteiro(a)","Maceió - AL","Sim","UFAL","Graduação",2025
"28","control",66,"4807c570-df62-11eb-bf23-972ef7bdc96c",1625689305171,1625689740431,"default",7.14142842854285,2.555555556,"3,2,3,2,2,2,2,4,3",3,2,3,2,2,2,2,4,3,"4, 4, 3, 3, 5, 4",4,4,3,3,5,4,5,3.33,"2,2,3,2,4,3,5,6,3,6,2,1,2,4,2,2,7",2,2,3,2,4,3,5,6,3,6,2,1,2,4,2,2,7,1.666666667,3.75,2.96,2.67,5,2.83,3.875,"5,5,4,3,3,4,3,4",5,5,4,3,3,4,3,4,"Masculino",20,"Pardo","Heterossexual","Solteiro(a)","Maceió","Sim","Ufal","Graduação",2023
"30","control",70,"9bf2ecf0-df62-11eb-bf23-972ef7bdc96c",1625689257833,1625689859604,"default",9,2.111111111,"3,2,1,1,1,1,1,5,4",3,2,1,1,1,1,1,5,4,"5, 5, 1, 1, 5, 1",5,5,1,1,5,1,7,2.33,"7,7,7,1,7,7,1,1,1,1,1,1,1,7,7,7,1",7,7,7,1,7,7,1,1,1,1,1,1,1,7,7,7,1,1,5.5,1.75,6,1,6.5,2,"1,1,1,5,1,1,5,1",1,1,1,5,1,1,5,1,"Masculino",20,"Pardo","Heterossexual","Solteiro(a)","Maceió","Sim","Universidade Federal de Alagoas - UFAL","Graduação",2024
"31","control",73,"ba97c630-df62-11eb-bf23-972ef7bdc96c",1625689268522,1625689939274,"default",5.56776436283002,3.222222222,"1,2,4,3,4,5,5,2,3",1,2,4,3,4,5,5,2,3,"2, 5, 4, 3, 5, 4",2,5,4,3,5,4,4,3,"3,3,1,1,4,1,6,7,7,6,2,1,1,4,2,4,7",3,3,1,1,4,1,6,7,7,6,2,1,1,4,2,4,7,1.333333333,4.25,2.54,2.17,6.5,1.83,4.25,"5,4,5,1,5,5,5,4",5,4,5,1,5,5,5,4,"Feminino",19,"Branco","Heterossexual","Solteiro(a)","barreiros-Pe","Sim","ufal","Graduação",2024
"34","control",84,"4aee3340-e657-11eb-aeff-859c71bd906c",1626454027888,1626454699593,"default",5.56776436283002,3,"3,3,2,2,5,3,2,5,2",3,3,2,2,5,3,2,5,2,"3, 4, 1, 1, 5, 1",3,4,1,1,5,1,8,1.67,"1,1,1,1,3,7,7,7,7,2,4,1,1,5,6,3,4",1,1,1,1,3,7,7,7,7,2,4,1,1,5,6,3,4,2,4.5,2.75,2.33,5.75,2.29,3.125,"5,1,3,3,4,3,3,3",5,1,3,3,4,3,3,3,"Masculino",23,"Branco","Heterossexual","Solteiro(a)","Arapiraca","Sim","Ufal","Graduação",2022
"35","control",85,"2dbcb190-e682-11eb-aeff-859c71bd906c",1626472399273,1626473093231,"default",5.56776436283002,2.444444444,"3,2,2,2,2,2,4,3,2",3,2,2,2,2,2,4,3,2,"2, 4, 3, 3, 5, 3",2,4,3,3,5,3,6,2.67,"3,5,5,2,6,3,4,5,5,3,2,2,2,5,4,5,4",3,5,5,2,6,3,4,5,5,3,2,2,2,5,4,5,4,2,4.5,2.75,4,4.25,3.88,4.375,"5,5,5,2,5,4,4,5",5,5,5,2,5,4,4,5,"Masculino",21,"Branco","Heterossexual","Solteiro(a)","Arapiraca","Sim","UFAL","Graduação",2025
"36","control",87,"00b46200-efb6-11eb-991d-7bf2f9a6c3b9",1627484553211,1627484904155,"default",9.53939201416946,3.444444444,"4,3,4,4,3,3,3,3,4",4,3,4,4,3,3,3,3,4,"3, 4, 3, 3, 4, 4",3,4,3,3,4,4,6,3,"3,3,2,1,3,1,7,4,5,7,1,1,1,4,5,5,6",3,3,2,1,3,1,7,4,5,7,1,1,1,4,5,5,6,1,5,2,2.17,5.75,2.21,3.125,"3,5,3,2,2,3,3,4",3,5,3,2,2,3,3,4,"Masculino",25,"Pardo","Heterossexual","Solteiro(a)","Penedo","Sim","Universidade Federal de Alagoas","Graduação",2023
"37","control",91,"9dff1b40-efb6-11eb-991d-7bf2f9a6c3b9",1627484617000,1627485093751,"default",9.53939201416946,2.777777778,"3,2,3,3,3,2,3,3,3",3,2,3,3,3,2,3,3,3,"2, 2, 3, 2, 3, 3",2,2,3,2,3,3,10,2.33,"3,3,6,2,6,6,2,3,1,3,4,4,4,5,4,3,3",3,3,6,2,6,6,2,3,1,3,4,4,4,5,4,3,3,4,3.75,4.13,4.33,2.25,5.04,2.25,"3,1,2,2,2,3,2,3",3,1,2,2,2,3,2,3,"Feminino",22,"Pardo","Heterossexual","Solteiro(a)","Maceió-AL","Sim","Universidade Federal de Alagoas","Graduação",2023
"38","control",93,"ee21a200-efb6-11eb-991d-7bf2f9a6c3b9",1627484599157,1627485261850,"default",8.42614977317636,2.666666667,"2,2,3,2,3,3,1,4,4",2,2,3,2,3,3,1,4,4,"3, 4, 3, 4, 5, 3",3,4,3,4,5,3,6,3.33,"4,2,5,2,7,6,2,4,2,2,4,6,3,2,2,1,2",4,2,5,2,7,6,2,4,2,2,4,6,3,2,2,1,2,4.333333333,1.75,5.29,4.33,2.5,4.92,2.625,"2,1,2,4,4,2,2,4",2,1,2,4,4,2,2,4,"Feminino",20,"Branco","Prefiro não Responder","Solteiro(a)","Maceió","Sim","UFAL","Graduação",3
"39","control",97,"27025510-efb7-11eb-991d-7bf2f9a6c3b9",1627484550621,1627485385657,"default",5.56776436283002,3.333333333,"3,3,4,3,3,3,4,4,3",3,3,4,3,3,3,4,4,3,"4, 2, 3, 3, 4, 2",4,2,3,3,4,2,10,3.33,"6,6,6,1,5,6,3,5,3,2,1,1,1,6,4,6,5",6,6,6,1,5,6,3,5,3,2,1,1,1,6,4,6,5,1,5.25,1.88,5,3.25,4.88,4,"4,5,4,3,4,4,3,5",4,5,4,3,4,4,3,5,"Masculino",20,"Branco","Heterossexual","Solteiro(a)","Maceió","Sim","Universidade Federal de Alagoas","Graduação",2024
"41","control",99,"15067de0-efb8-11eb-991d-7bf2f9a6c3b9",1627484795648,1627485763133,"default",7.81024967590665,3.333333333,"3,2,3,3,5,3,3,5,3",3,2,3,3,5,3,3,5,3,"3, 4, 3, 1, 5, 4",3,4,3,1,5,4,5,2.33,"3,1,1,1,7,1,5,5,5,4,5,5,1,1,1,1,3",3,1,1,1,7,1,5,5,5,4,5,5,1,1,1,1,3,3.666666667,1.5,5.08,2.33,4.75,2.79,2.5,"3,3,2,4,1,1,1,5",3,3,2,4,1,1,1,5,"Feminino",19,"Branco","Heterossexual","Solteiro(a)","Maceió","Sim","ufal","Graduação",2023
"42","control",101,"5ad35650-f6e7-11eb-991d-7bf2f9a6c3b9",1628275217396,1628275734261,"default",10.0498756211209,2.888888889,"3,1,3,3,3,3,4,3,3",3,1,3,3,3,3,4,3,3,"2, 4, 3, 2, 5, 2",2,4,3,2,5,2,7,2.33,"2,1,2,2,3,2,2,3,2,1,2,2,1,3,3,2,3",2,1,2,2,3,2,2,3,2,1,2,2,1,3,3,2,3,1.666666667,2.75,3.46,2,2,4,3.5,"4,3,3,3,4,4,3,4",4,3,3,3,4,4,3,4,"Feminino",22,"Negro","Heterossexual","Solteiro(a)","Maceió","Sim","UFAL","Graduação",3
"44","inBoost",2,"e6bed630-9d46-11eb-9b7e-0daf340a71ab",1618418879949,1618420998081,"stMale",4.58257569495584,3.444444444,"4,3,4,2,4,2,4,4,4",4,3,4,2,4,2,4,4,4,"4, 5, 3, 4, 5, 5",4,5,3,4,5,5,3,3.67,"1,1,3,1,3,3,3,7,2,5,1,3,1,7,7,7,5",1,1,3,1,3,3,3,7,2,5,1,3,1,7,7,7,5,1.666666667,6.5,1.58,2,4.25,2.88,4,"5,1,5,1,5,5,5,5",5,1,5,1,5,5,5,5,"Masculino",23,"Branco","Heterossexual","Solteiro(a)","Maceió","Sim","Ufal","Graduação",2023
"45","inBoost",3,"d23aa670-9d47-11eb-9b7e-0daf340a71ab",1618420882885,1618421540768,"stMale",6.40312423743285,4.222222222,"5,5,4,5,4,4,5,1,5",5,5,4,5,4,4,5,1,5,"3, 3, 3, 3, 4, 2",3,3,3,3,4,2,9,3,"2,2,2,1,1,2,6,6,6,7,1,1,1,7,6,6,7",2,2,2,1,1,2,6,6,6,7,1,1,1,7,6,6,7,1,6.5,1.25,1.67,6.25,1.71,4.25,"5,5,5,1,5,4,5,4",5,5,5,1,5,4,5,4,"Masculino",25,"Pardo","Heterossexual","Solteiro(a)","MACEIÓ","Sim","UFAL","Graduação",2023
"46","inBoost",4,"358e5340-9d4b-11eb-9b7e-0daf340a71ab",1618422301740,1618422916334,"stFemale",10.1956090606404,4,"3,3,4,5,5,3,5,5,3",3,3,4,5,5,3,5,5,3,"5, 1, 5, 1, 1, 1",5,1,5,1,1,1,15,3.67,"7,7,7,4,7,7,1,1,1,1,7,7,7,1,4,1,4",7,7,7,4,7,7,1,1,1,1,7,7,7,1,4,1,4,7,2.5,6.25,6.5,1,6.75,4,"5,5,5,5,5,3,1,3",5,5,5,5,5,3,1,3,"Feminino",48,"Negro","Homossexual","Solteiro(a)","","Sim","Ufal","Graduação",2025
"48","inBoost",12,"09bbd000-9e39-11eb-9b7e-0daf340a71ab",1618524679567,1618525250184,"stMale",3.3166247903554,4.333333333,"4,5,4,4,5,4,5,5,3",4,5,4,4,5,4,5,5,3,"5, 5, 4, 5, 4, 4",5,5,4,5,4,4,5,4.67,"5,1,2,1,4,1,7,7,7,7,1,1,1,6,6,7,7",5,1,2,1,4,1,7,7,7,7,1,1,1,6,6,7,7,1,6.5,1.25,2.33,7,1.67,4.875,"5,4,5,5,5,5,5,5",5,4,5,5,5,5,5,5,"Masculino",21,"Branco","Heterossexual","Solteiro(a)","São Paulo","Sim","UFAL","Graduação",2022
"49","inBoost",13,"936fd080-9e6b-11eb-9b7e-0daf340a71ab",1618545834282,1618546931980,"stFemale",4.58257569495584,3.777777778,"4,1,4,3,4,4,5,4,5",4,1,4,3,4,4,5,4,5,"4, 2, 2, 3, 1, 1",4,2,2,3,1,1,14,3,"4,1,4,1,7,2,6,6,6,4,2,2,1,7,7,6,6",4,1,4,1,7,2,6,6,6,4,2,2,1,7,7,6,6,1.666666667,6.5,1.58,3.17,5.5,2.83,4.625,"4,5,5,4,5,4,5,5",4,5,5,4,5,4,5,5,"Feminino",25,"Branco","Heterossexual","Solteiro(a)","Marechal Deodoro","Sim","UFAL","Graduação",2023
"50","inBoost",16,"1160f4b0-a439-11eb-8cbb-599e427a3fce",1619184152491,1619184697698,"stMale",9.53939201416946,4.777777778,"5,5,4,5,4,5,5,5,5",5,5,4,5,4,5,5,5,5,"3, 5, 3, 3, 5, 3",3,5,3,3,5,3,5,3,"6,6,7,5,7,7,3,6,5,2,6,6,6,2,4,2,2",6,6,7,5,7,7,3,6,5,2,6,6,6,2,4,2,2,6,2.5,5.75,6.33,4,5.17,3,"4,4,2,5,2,1,2,4",4,4,2,5,2,1,2,4,"Masculino",47,"Pardo","Heterossexual","Casado(a)","MANAUS","Sim","IBAC","Outros",2022
"51","inBoost",22,"0cae3c90-a81f-11eb-8cbb-599e427a3fce",1619613135745,1619613581292,"stFemale",7.14142842854285,2.444444444,"4,1,3,2,2,3,2,1,4",4,1,3,2,2,3,2,1,4,"4, 5, 2, 5, 5, 5",4,5,2,5,5,5,3,3.67,"1,1,1,1,3,1,4,4,4,4,1,2,1,4,4,4,4",1,1,1,1,3,1,4,4,4,4,1,2,1,4,4,4,4,1.333333333,4,2.67,1.33,4,2.67,4,"5,5,3,1,5,5,3,5",5,5,3,1,5,5,3,5,"Feminino",19,"Branco","Heterossexual","Solteiro(a)","Campo Grande","Sim","UFMS","Graduação",2024
"52","inBoost",24,"b5e0a910-a833-11eb-8cbb-599e427a3fce",1619622138242,1619622726081,"stMale",5.56776436283002,3.444444444,"4,2,4,3,3,3,3,4,5",4,2,4,3,3,3,3,4,5,"4, 4, 3, 4, 5, 5",4,4,3,4,5,5,4,3.67,"2,2,4,1,2,5,2,5,2,6,2,2,1,6,6,6,4",2,2,4,1,2,5,2,5,2,6,2,2,1,6,6,6,4,1.666666667,5.5,2.08,2.67,3.75,3.46,3.875,"3,4,3,4,5,3,5,4",3,4,3,4,5,3,5,4,"Masculino",20,"Branco","Heterossexual","Solteiro(a)","Campo Grande","Sim","Universidade Federal Do Mato Grosso Do Sul","Graduação",2024
"53","inBoost",29,"eb0ea380-aeb9-11eb-8cbb-599e427a3fce",1620339251971,1620339719942,"stMale",10.0498756211209,3.555555556,"3,1,5,5,4,4,3,5,2",3,1,5,5,4,4,3,5,2,"3, 2, 4, 4, 1, 1",3,2,4,4,1,1,14,3.67,"6,4,7,1,3,1,7,5,7,7,1,1,1,5,5,5,5",6,4,7,1,3,1,7,5,7,7,1,1,1,5,5,5,5,1,5,2,3.67,6.5,2.58,4.875,"5,5,5,5,4,5,5,5",5,5,5,5,4,5,5,5,"Masculino",49,"Branco","Heterossexual","Casado(a)","Jaboatão dos Guararapes","Sim","IFPE","Doutorado",2026
"54","inBoost",35,"d79c21e0-b1db-11eb-b944-15c8c1c6ce71",1620683172964,1620684245218,"stMale",5.56776436283002,2.777777778,"4,1,3,2,4,3,4,2,2",4,1,3,2,4,3,4,2,2,"3, 4, 3, 3, 5, 4",3,4,3,3,5,4,5,3,"1,1,4,2,4,2,5,5,6,6,5,5,2,2,2,2,7",1,1,4,2,4,2,5,5,6,6,5,5,2,2,2,2,7,4,3.25,4.38,2.33,5.5,2.42,3.875,"5,4,5,2,2,5,3,5",5,4,5,2,2,5,3,5,"Masculino",21,"Pardo","Heterossexual","Solteiro(a)","Sobradinho","Sim","UnB","Graduação",2023
"55","inBoost",39,"77a7a000-b264-11eb-b944-15c8c1c6ce71",1620742554261,1620742929559,"stMale",5.56776436283002,3.111111111,"4,3,4,3,2,2,2,4,4",4,3,4,3,2,2,2,4,4,"3, 2, 2, 2, 2, 2",3,2,2,2,2,2,12,2.33,"2,2,3,1,3,3,5,7,4,6,1,2,1,6,4,3,5",2,2,3,1,3,3,5,7,4,6,1,2,1,6,4,3,5,1.333333333,4.5,2.42,2.33,5.5,2.42,2.625,"4,1,4,2,1,3,3,3",4,1,4,2,1,3,3,3,"Masculino",22,"Pardo","Heterossexual","Solteiro(a)","Taguatinga","Sim","Universidade de Brasilia","Graduação",2022
"56","inBoost",41,"08506260-b812-11eb-93e6-43229aa359ae",1621365406713,1621367195820,"stMale",9.53939201416946,3,"4,5,2,1,2,1,4,5,3",4,5,2,1,2,1,4,5,3,"3, 1, 1, 4, 1, 1",3,1,1,4,1,1,15,2.67,"3,3,3,6,7,4,4,2,6,6,4,3,5,4,3,5,5",3,3,3,6,7,4,4,2,6,6,4,3,5,4,3,5,5,4,4.25,3.88,4.33,4.5,3.92,2.875,"2,4,3,4,3,2,3,2",2,4,3,4,3,2,3,2,"Masculino",26,"Branco","Heterossexual","Solteiro(a)","Ceilândia","Sim","UnB","",NA
"57","inBoost",44,"63642710-b829-11eb-93e6-43229aa359ae",1621376622399,1621377222178,"stFemale",5.56776436283002,3.555555556,"3,2,4,4,3,3,4,4,5",3,2,4,4,3,3,4,4,5,"4, 5, 5, 4, 5, 4",4,5,5,4,5,4,4,4.33,"1,1,2,1,3,2,5,7,4,4,4,2,1,1,3,3,4",1,1,2,1,3,2,5,7,4,4,4,2,1,1,3,3,4,2.333333333,2.75,3.79,1.67,5,2.33,3.75,"3,4,4,2,5,4,3,5",3,4,4,2,5,4,3,5,"Feminino",33,"Pardo","Heterossexual","Solteiro(a)","Maceió","Sim","UFAL","Graduação",2021
"58","inBoost",45,"8fe50750-b82e-11eb-93e6-43229aa359ae",1621378457469,1621379414540,"stMale",5.56776436283002,3.555555556,"4,3,4,4,4,3,4,4,2",4,3,4,4,4,3,4,4,2,"3, 4, 4, 4, 5, 5",3,4,4,4,5,5,4,3.67,"3,2,3,1,3,2,6,6,5,6,2,2,1,5,6,6,6",3,2,3,1,3,2,6,6,5,6,2,2,1,5,6,6,6,1.666666667,5.75,1.96,2.33,5.75,2.29,4,"4,3,4,4,5,4,4,4",4,3,4,4,5,4,4,4,"Masculino",24,"Branco","Heterossexual","Solteiro(a)","Maceió","Sim","UFAL","Graduação",2026
"59","inBoost",47,"a17bb480-bf06-11eb-93e6-43229aa359ae",1622128933140,1622131697258,"stMale",3.3166247903554,3,"3,3,3,3,3,3,3,3,3",3,3,3,3,3,3,3,3,3,"3, 3, 3, 3, 3, 3",3,3,3,3,3,3,9,3,"2,2,2,1,3,1,6,6,6,6,2,2,2,6,5,6,6",2,2,2,1,3,1,6,6,6,6,2,2,2,6,5,6,6,2,5.75,2.13,1.83,6,1.92,4.375,"5,4,5,4,5,4,4,4",5,4,5,4,5,4,4,4,"Masculino",20,"Pardo","Heterossexual","Solteiro(a)","","Sim","UnB","Graduação",NA
"60","inBoost",49,"0ed06520-c18d-11eb-93e6-43229aa359ae",1622409002885,1622409620393,"stMale",4.58257569495584,3,"3,2,3,3,2,2,4,4,4",3,2,3,3,2,2,4,4,4,"4, 4, 3, 4, 4, 3",4,4,3,4,4,3,7,3.67,"4,5,5,2,5,3,5,5,5,4,3,2,2,5,5,4,4",4,5,5,2,5,3,5,5,5,4,3,2,2,5,5,4,4,2.333333333,4.5,2.92,4,4.75,3.63,4.5,"5,5,4,4,5,5,4,4",5,5,4,4,5,5,4,4,"Masculino",39,"Branco","Heterossexual","União estável","Joinville","Sim","Udesc - Joinville","Graduação",2006
"61","inBoost",52,"cc9a1970-dba5-11eb-916d-ef9a5fc9a834",1625278319917,1625278970072,"stFemale",6.40312423743285,3.666666667,"4,4,4,3,2,4,2,5,5",4,4,4,3,2,4,2,5,5,"4, 5, 4, 3, 4, 4",4,5,4,3,4,4,5,3.67,"6,6,6,4,6,5,3,6,3,5,4,5,5,4,6,5,7",6,6,6,4,6,5,3,6,3,5,4,5,5,4,6,5,7,4.666666667,5.5,3.58,5.5,4.25,4.63,4,"5,3,5,4,4,4,4,3",5,3,5,4,4,4,4,3,"Feminino",21,"Prefiro não Responder","Bissexual","Solteiro(a)","Maceió","Sim","UFAL","Graduação",2022
"62","inBoost",56,"8b51aea0-df61-11eb-bf23-972ef7bdc96c",1625689115410,1625689435899,"stMale",10.0498756211209,3.111111111,"3,4,4,3,3,3,4,1,3",3,4,4,3,3,3,4,1,3,"4, 5, 3, 3, 5, 4",4,5,3,3,5,4,4,3.33,"3,1,1,1,4,2,6,6,7,5,2,3,1,4,5,4,7",3,1,1,1,4,2,6,6,7,5,2,3,1,4,5,4,7,2,5,2.5,2,6,2,3.75,"4,5,4,1,4,4,3,5",4,5,4,1,4,4,3,5,"Masculino",20,"Pardo","Heterossexual","Solteiro(a)","Maceió","Sim","UFAL","Graduação",2024
"63","inBoost",60,"f343a310-df61-11eb-bf23-972ef7bdc96c",1625689142358,1625689645454,"stMale",6.40312423743285,3.222222222,"5,2,3,2,4,2,1,5,5",5,2,3,2,4,2,1,5,5,"3, 1, 4, 4, 5, 3",3,1,4,4,5,3,9,3.67,"2,4,2,1,2,4,6,6,5,6,1,1,1,6,4,4,4",2,4,2,1,2,4,6,6,5,6,1,1,1,6,4,4,4,1,4.5,2.25,2.5,5.75,2.38,3.75,"5,1,5,1,5,5,3,5",5,1,5,1,5,5,3,5,"Masculino",21,"Pardo","Heterossexual","Solteiro(a)","MACEIÓ","Sim","ufal","Graduação",2025
"64","inBoost",61,"fe2e21b0-df61-11eb-bf23-972ef7bdc96c",1625689189923,1625689655192,"stMale",6.40312423743285,3.333333333,"3,3,4,3,3,4,4,3,3",3,3,4,3,3,4,4,3,3,"3, 3, 3, 3, 3, 3",3,3,3,3,3,3,9,3,"1,1,1,1,2,1,7,,5,7,1,1,1,4,4,4,4",1,1,1,1,2,1,7,NA,5,7,1,1,1,4,4,4,4,1,4,2.5,1.17,6.33,1.42,3.625,"5,5,3,1,4,5,3,3",5,5,3,1,4,5,3,3,"Masculino",23,"Branco","Heterossexual","Solteiro(a)","União Dos Palmares","Sim","Ufal","Graduação",NA
"65","inBoost",65,"4282ceb0-df62-11eb-bf23-972ef7bdc96c",1625689164892,1625689744465,"stMale",7.14142842854285,3.777777778,"4,3,4,4,4,5,2,4,4",4,3,4,4,4,5,2,4,4,"4, 5, 3, 4, 5, 5",4,5,3,4,5,5,3,3.67,"3,3,4,2,5,1,6,6,6,4,2,2,2,4,2,3,4",3,3,4,2,5,1,6,6,6,4,2,2,2,4,2,3,4,2,3.25,3.38,3,5.5,2.75,3.25,"5,4,4,1,3,3,3,3",5,4,4,1,3,3,3,3,"Masculino",19,"Branco","Heterossexual","Solteiro(a)","Maceió","Sim","UFAL","Outros",2024
"66","inBoost",74,"bb4962f0-df62-11eb-bf23-972ef7bdc96c",1625689144081,1625689959093,"stMale",3.3166247903554,4.444444444,"4,4,5,5,3,5,5,4,5",4,4,5,5,3,5,5,4,5,"5, 2, 4, 5, 4, 1",5,2,4,5,4,1,11,4.67,"4,1,1,1,1,2,1,6,2,2,1,1,1,6,6,5,5",4,1,1,1,1,2,1,6,2,2,1,1,1,6,6,5,5,1,5.5,1.75,1.67,2.75,3.46,4.5,"5,4,5,2,5,5,5,5",5,4,5,2,5,5,5,5,"Masculino",20,"Pardo","Heterossexual","Solteiro(a)","MACEIÓ","Sim","ufal","Graduação",2024
"67","inBoost",75,"ed40fb60-df62-11eb-bf23-972ef7bdc96c",1625689216572,1625689960325,"stFemale",8.42614977317636,3.555555556,"3,3,4,3,4,2,4,4,5",3,3,4,3,4,2,4,4,5,"3, 1, 3, 4, 4, 5",3,1,3,4,4,5,8,3.33,"2,1,3,1,5,3,6,6,5,6,4,3,1,7,7,7,6",2,1,3,1,5,3,6,6,5,6,4,3,1,7,7,7,6,2.666666667,6.75,1.96,2.5,5.75,2.38,4.625,"5,4,4,5,5,4,5,5",5,4,4,5,5,4,5,5,"Feminino",19,"Branco","Heterossexual","Solteiro(a)","Arapiraca","Sim","UFAL","Graduação",2024
"68","inBoost",76,"20b9dca0-df63-11eb-bf23-972ef7bdc96c",1625689301560,1625690098312,"stMale",8.42614977317636,2.444444444,"2,1,2,3,1,3,4,4,2",2,1,2,3,1,3,4,4,2,"4, 4, 4, 4, 5, 4",4,4,4,4,5,4,5,4,"7,2,6,1,3,3,6,5,3,1,2,2,1,4,6,4,6",7,2,6,1,3,3,6,5,3,1,2,2,1,4,6,4,6,1.666666667,5,2.33,3.67,3.75,3.96,3.875,"5,4,2,5,4,4,3,4",5,4,2,5,4,4,3,4,"Masculino",26,"Negro","Heterossexual","Solteiro(a)","Rolim de Moura","Sim","UFAL","Graduação",3
"69","inBoost",78,"25210750-df63-11eb-bf23-972ef7bdc96c",1625689608465,1625690090821,"stMale",6.40312423743285,4,"5,2,4,5,4,4,4,4,4",5,2,4,5,4,4,4,4,4,"4, 4, 3, 4, 5, 4",4,4,3,4,5,4,5,3.67,"5,4,4,2,3,2,6,6,5,4,2,2,2,5,5,4,6",5,4,4,2,3,2,6,6,5,4,2,2,2,5,5,4,6,2,5,2.5,3.33,5.25,3.04,4.375,"5,5,4,4,5,5,3,4",5,5,4,4,5,5,3,4,"Masculino",21,"Branco","Heterossexual","Solteiro(a)","Maceió","Sim","Universidade Federal de Alagoas","Graduação",2024
"70","inBoost",82,"3ee47f00-df72-11eb-bf23-972ef7bdc96c",1625695525960,1625696204660,"stFemale",4.58257569495584,3.444444444,"4,2,4,2,4,3,4,5,3",4,2,4,2,4,3,4,5,3,"3, 5, 3, 3, 5, 4",3,5,3,3,5,4,4,3,"5,3,3,1,5,5,3,4,4,3,2,2,2,4,4,3,4",5,3,3,1,5,5,3,4,4,3,2,2,2,4,4,3,4,2,3.75,3.13,3.67,3.5,4.08,3.625,"4,4,3,4,3,3,3,5",4,4,3,4,3,3,3,5,"Feminino",21,"Pardo","Heterossexual","Solteiro(a)","Maceió","Sim","UFAL","Graduação",2024
"71","inBoost",83,"8047d7e0-e656-11eb-aeff-859c71bd906c",1626454064062,1626454422716,"stMale",3.3166247903554,3.333333333,"4,4,5,3,3,2,2,4,3",4,4,5,3,3,2,2,4,3,"2, 3, 3, 3, 5, 2",2,3,3,3,5,2,8,2.67,"4,5,5,1,1,4,4,6,6,3,1,1,1,6,5,5,5",4,5,5,1,1,4,4,6,6,3,1,1,1,6,5,5,5,1,5.25,1.88,3.33,4.75,3.29,4.625,"5,5,4,3,5,5,5,5",5,5,4,3,5,5,5,5,"Masculino",22,"Pardo","Heterossexual","Solteiro(a)","Limoeiro de Anadia","Sim","UFAL","Graduação",2023
"72","inBoost",94,"fdc45180-efb6-11eb-991d-7bf2f9a6c3b9",1627484632134,1627485310517,"stFemale",7.14142842854285,3.444444444,"3,2,4,4,4,3,3,5,3",3,2,4,4,4,3,3,5,3,"3, 3, 3, 3, 5, 3",3,3,3,3,5,3,7,3,"4,3,3,1,5,2,3,4,5,5,3,3,2,4,4,3,5",4,3,3,1,5,2,3,4,5,5,3,3,2,4,4,3,5,2.666666667,4,3.33,3,4.25,3.38,4,"5,5,4,3,5,3,3,4",5,5,4,3,5,3,3,4,"Feminino",21,"Branco","Heterossexual","Solteiro(a)","Maceió","Sim","UFAL","Graduação",2024
"73","inBoost",100,"37869fe0-f6e7-11eb-991d-7bf2f9a6c3b9",1628275209826,1628275738638,"stFemale",8.42614977317636,3.555555556,"4,3,4,3,3,3,4,5,3",4,3,4,3,3,3,4,5,3,"3, 5, 4, 4, 4, 4",3,5,4,4,4,4,5,3.67,"2,3,5,1,4,1,7,5,4,7,1,1,1,4,4,4,4",2,3,5,1,4,1,7,5,4,7,1,1,1,4,4,4,4,1,4,2.5,2.67,5.75,2.46,3.5,"3,2,5,5,4,3,3,3",3,2,5,5,4,3,3,3,"Feminino",35,"Branco","Heterossexual","Casado(a)","Maceió","Sim","UFAL","Graduação",2023
"74","inBoost",102,"670fa950-f6e7-11eb-991d-7bf2f9a6c3b9",1628275270435,1628275791276,"stFemale",7.81024967590665,3.222222222,"5,3,4,3,2,2,1,5,4",5,3,4,3,2,2,1,5,4,"1, 1, 4, 1, 3, 1",1,1,4,1,3,1,13,2,"5,6,6,5,5,6,2,3,4,2,6,6,4,1,2,1,5",5,6,6,5,5,6,2,3,4,2,6,6,4,1,2,1,5,5.333333333,2.25,5.54,5.5,2.75,5.38,2,"5,2,1,4,1,1,1,1",5,2,1,4,1,1,1,1,"Feminino",19,"Pardo","Heterossexual","Solteiro(a)","Maceió","Sim","UFAL","Graduação",2015
"75","inBoost",103,"a59955e0-f6e7-11eb-991d-7bf2f9a6c3b9",1628275285186,1628275891680,"stFemale",6.40312423743285,3.333333333,"2,2,4,3,3,3,4,4,5",2,2,4,3,3,3,4,4,5,"4, 5, 4, 4, 4, 3",4,5,4,4,4,3,6,4,"1,1,2,1,6,1,7,5,7,7,2,2,1,6,6,6,6",1,1,2,1,6,1,7,5,7,7,2,2,1,6,6,6,6,1.666666667,6,1.83,2,6.5,1.75,4.375,"5,5,4,3,5,4,4,5",5,5,4,3,5,4,4,5,"Feminino",20,"Pardo","Homossexual","Solteiro(a)","Rio Largo","Sim","UFAL","Graduação",2022
"76","inBoost",104,"f8b19d00-f6e7-11eb-991d-7bf2f9a6c3b9",1628275372963,1628276020185,"stFemale",9.53939201416946,3.333333333,"5,1,5,1,5,3,2,5,3",5,1,5,1,5,3,2,5,3,"4, 5, 1, 5, 5, 5",4,5,1,5,5,5,3,3.33,"2,2,3,1,4,1,4,4,4,4,1,1,1,5,5,5,5",2,2,3,1,4,1,4,4,4,4,1,1,1,5,5,5,5,1,5,2,2.17,4,3.08,3.125,"2,2,4,5,3,3,3,3",2,2,4,5,3,3,3,3,"Feminino",20,"Branco","Heterossexual","Solteiro(a)","Rio Largo","Sim","Ufal","Graduação",2023
"77","inBoost",105,"175e8c90-f6e8-11eb-991d-7bf2f9a6c3b9",1628275231812,1628276109771,"stFemale",5.56776436283002,3.666666667,"4,3,4,4,4,3,3,3,5",4,3,4,4,4,3,3,3,5,"4, 5, 5, 5, 5, 5",4,5,5,5,5,5,3,4.67,"7,4,3,1,2,2,3,3,3,3,4,3,3,3,4,4,4",7,4,3,1,2,2,3,3,3,3,4,3,3,3,4,4,4,3.333333333,3.75,3.79,3.17,3,4.08,2.5,"3,3,3,3,3,1,1,3",3,3,3,3,3,1,1,3,"Feminino",22,"Branco","Heterossexual","Solteiro(a)","Maceió","Sim","Ufal","Graduação",2023
"78","inBoost",106,"48089660-f6e8-11eb-991d-7bf2f9a6c3b9",1628275356422,1628276180800,"stFemale",6.40312423743285,2.888888889,"3,3,2,3,3,3,2,4,3",3,3,2,3,3,3,2,4,3,"3, 5, 4, 5, 5, 5",3,5,4,5,5,5,3,4,"5,1,5,1,5,5,2,5,1,3,1,1,1,6,5,6,3",5,1,5,1,5,5,2,5,1,3,1,1,1,6,5,6,3,1,5,2,3.67,2.75,4.46,4.375,"4,5,5,5,4,3,5,4",4,5,5,5,4,3,5,4,"Feminino",20,"Branco","Heterossexual","Solteiro(a)","Maceió","Sim","Ufal","Graduação",2023
"79","inThreat",1,"208ec0b0-9d46-11eb-9b7e-0daf340a71ab",1618420145528,1618420954258,"stFemale",7.14142842854285,4.222222222,"2,4,4,5,5,3,5,5,5",2,4,4,5,5,3,5,5,5,"4, 3, 5, 4, 2, 2",4,3,5,4,2,2,11,4.33,"7,6,7,5,6,1,7,4,6,6,5,5,4,6,5,5,4",7,6,7,5,6,1,7,4,6,6,5,5,4,6,5,5,4,4.666666667,5,3.83,5.33,5.75,3.79,3.875,"4,3,4,3,4,4,5,4",4,3,4,3,4,4,5,4,"Masculino",25,"Pardo","Heterossexual","Solteiro(a)","MACEIÓ","Sim","UFAL","Graduação",8
"80","inThreat",5,"4b869a80-9d4c-11eb-9b7e-0daf340a71ab",1618423216595,1618423569437,"stMale",7.81024967590665,3.333333333,"4,1,4,3,4,4,4,3,3",4,1,4,3,4,4,4,3,3,"4, 5, 3, 4, 2, 2",4,5,3,4,2,2,9,3.67,"1,1,1,1,2,2,6,4,6,3,5,1,1,4,4,3,6",1,1,1,1,2,2,6,4,6,3,5,1,1,4,4,3,6,2.333333333,4.25,3.04,1.33,4.75,2.29,3.625,"4,5,3,2,4,4,3,4",4,5,3,2,4,4,3,4,"Feminino",21,"Pardo","Heterossexual","Solteiro(a)","Maceió","Sim","Universidade Federal de Alagoas","Graduação",2022
"81","inThreat",9,"906a5a80-9e30-11eb-9b7e-0daf340a71ab",1618521419844,1618521649027,"stMale",5.56776436283002,5,"5,5,5,5,5,5,5,5,5",5,5,5,5,5,5,5,5,5,"4, 2, 2, 4, 3, 1",4,2,2,4,3,1,12,3.33,"6,6,6,1,6,5,1,7,1,1,1,5,1,5,5,5,2",6,6,6,1,6,5,1,7,1,1,1,5,1,5,5,5,2,2.333333333,4.25,3.04,5,2.5,5.25,5,"5,5,5,5,5,5,5,5",5,5,5,5,5,5,5,5,"Feminino",18,"Branco","Heterossexual","Solteiro(a)","Maceio","Sim","UFAL","Graduação",2026
"82","inThreat",14,"08861510-9ebb-11eb-9b7e-0daf340a71ab",1618580786711,1618581023344,"stMale",9.53939201416946,3.777777778,"4,3,4,5,4,3,3,4,4",4,3,4,5,4,3,3,4,4,"4, 5, 4, 4, 5, 5",4,5,4,4,5,5,3,4,"4,2,4,1,3,1,5,6,3,3,3,3,1,4,4,4,4",4,2,4,1,3,1,5,6,3,3,3,3,1,4,4,4,4,2.333333333,4,3.17,2.5,4.25,3.13,3.25,"4,3,3,1,3,4,4,4",4,3,3,1,3,4,4,4,"Feminino",24,"Negro","Heterossexual","Solteiro(a)","","Sim","","Outros",2022
"84","inThreat",19,"a5bebe50-a48c-11eb-8cbb-599e427a3fce",1619220170772,1619220799188,"stMale",7.81024967590665,3.222222222,"3,3,3,4,3,4,3,3,3",3,3,3,4,3,4,3,3,3,"4, 3, 4, 4, 3, 2",4,3,4,4,3,2,10,4,"5,4,4,3,4,3,5,6,4,4,3,3,3,6,6,6,6",5,4,4,3,4,3,5,6,4,4,3,3,3,6,6,6,6,3,6,2.5,3.83,4.75,3.54,4.75,"5,5,5,4,4,5,5,5",5,5,5,4,4,5,5,5,"Feminino",52,"Branco","Heterossexual","Casado(a)","Brasilia","Não","","Graduação",NA
"85","inThreat",23,"48ed6aa0-a824-11eb-8cbb-599e427a3fce",1619614119186,1619615819166,"stFemale",7.81024967590665,3,"4,3,3,2,3,3,4,3,2",4,3,3,2,3,3,4,3,2,"3, 1, 2, 1, 3, 3",3,1,2,1,3,3,11,2,"1,1,1,1,5,1,2,4,4,6,2,2,1,3,3,3,6",1,1,1,1,5,1,2,4,4,6,2,2,1,3,3,3,6,1.666666667,3.75,2.96,1.67,4,2.83,3.375,"5,5,4,1,3,4,3,2",5,5,4,1,3,4,3,2,"Masculino",26,"Branco","Assexual","Solteiro(a)","Campo Grande","Sim","UFMS","Graduação",2023
"86","inThreat",25,"b70e56d0-a837-11eb-8cbb-599e427a3fce",1619623644257,1619624160660,"stFemale",3.3166247903554,3.111111111,"3,2,4,4,5,3,1,1,5",3,2,4,4,5,3,1,1,5,"4, 3, 2, 2, 2, 2",4,3,2,2,2,2,11,2.67,"1,1,2,3,,2,6,6,7,7,2,2,2,1,1,1,4",1,1,2,3,NA,2,6,6,7,7,2,2,2,1,1,1,4,2,1.75,4.13,1.8,6.5,1.65,3.875,"5,2,4,2,5,4,4,5",5,2,4,2,5,4,4,5,"Masculino",18,"Branco","Prefiro não Responder","Solteiro(a)","Campo Grande - MS","Sim","UFMS","Graduação",2025
"87","inThreat",30,"3d203cb0-af41-11eb-b944-15c8c1c6ce71",1620397310059,1620397854960,"stMale",4.58257569495584,3.444444444,"3,1,5,3,5,5,1,5,3",3,1,5,3,5,5,1,5,3,"5, 5, 5, 5, 5, 4",5,5,5,5,5,4,4,5,"4,5,6,1,3,6,2,7,2,4,3,3,1,7,7,7,5",4,5,6,1,3,6,2,7,2,4,3,3,1,7,7,7,5,2.333333333,6.5,1.92,4.17,3.75,4.21,4.75,"4,5,5,5,5,5,4,5",4,5,5,5,5,5,4,5,"Feminino",25,"Negro","Homossexual","Solteiro(a)","Maceió","Não","Universidade Federal de Alagoas","Graduação",NA
"88","inThreat",32,"8a1d24d0-b183-11eb-b944-15c8c1c6ce71",1620645395912,1620646240228,"stFemale",7.14142842854285,4.111111111,"3,2,5,4,5,4,5,5,4",3,2,5,4,5,4,5,5,4,"3, 3, 5, 5, 2, 2",3,3,5,5,2,2,11,4.33,"2,1,2,1,3,1,6,7,7,7,1,1,1,4,4,4,7",2,1,2,1,3,1,6,7,7,7,1,1,1,4,4,4,7,1,4.75,2.13,1.67,6.75,1.46,4.125,"5,5,4,3,5,4,2,5",5,5,4,3,5,4,2,5,"Masculino",56,"Branco","Heterossexual","Divorciado(a)","Itajaí","Sim","UNIVALI","Mestrado",2022
"89","inThreat",42,"65ae5870-b819-11eb-93e6-43229aa359ae",1621369944618,1621370358940,"stFemale",7.81024967590665,3,"4,3,3,5,3,1,1,5,2",4,3,3,5,3,1,1,5,2,"3, 5, 2, 1, 5, 4",3,5,2,1,5,4,4,2,"1,1,7,1,7,6,1,1,1,4,1,5,1,1,1,1,1",1,1,7,1,7,6,1,1,1,4,1,5,1,1,1,1,1,2.333333333,1,4.67,3.83,1.75,5.04,2.25,"5,1,2,5,1,1,2,1",5,1,2,5,1,1,2,1,"Masculino",20,"Pardo","Heterossexual","Solteiro(a)","Feira Grande - AL","Sim","UFAL","Graduação",2026
"90","inThreat",43,"5f6ad630-b825-11eb-93e6-43229aa359ae",1621375094890,1621375508474,"stMale",7.81024967590665,3,"3,1,5,3,2,2,1,5,5",3,1,5,3,2,2,1,5,5,"3, 1, 5, 3, 5, 5",3,1,5,3,5,5,7,3.67,"7,7,7,3,4,7,1,7,1,1,3,3,3,6,6,6,1",7,7,7,3,4,7,1,7,1,1,3,3,3,6,6,6,1,3,4.75,3.13,5.83,2.5,5.67,3.5,"5,1,5,1,5,4,3,4",5,1,5,1,5,4,3,4,"Feminino",23,"Pardo","Heterossexual","Solteiro(a)","Maribondo","Sim","Ufal","Graduação",2023
"91","inThreat",50,"12bc0350-c463-11eb-9261-891d55fc2af9",1622720539000,1622721230505,"stMale",9.53939201416946,4.111111111,"4,2,5,4,5,4,4,5,4",4,2,5,4,5,4,4,5,4,"4, 4, 3, 4, 5, 5",4,4,3,4,5,5,4,3.67,"1,1,1,1,2,1,7,7,7,7,4,4,1,5,4,4,4",1,1,1,1,2,1,7,7,7,7,4,4,1,5,4,4,4,3,4.25,3.38,1.17,7,1.08,3.625,"3,3,4,4,4,4,3,4",3,3,4,4,4,4,3,4,"Feminino",56,"Pardo","Heterossexual","Solteiro(a)","Maceió","Sim","UFAL","Outros",NA
"92","inThreat",51,"c5628d20-c7cf-11eb-9261-891d55fc2af9",1623095914841,1623097598250,"stMale",5.56776436283002,3.666666667,"4,3,5,4,4,3,3,2,5",4,3,5,4,4,3,3,2,5,"3, 5, 4, 4, 5, 4",3,5,4,4,5,4,4,3.67,"5,1,1,1,6,1,6,6,7,6,2,2,1,3,3,2,3",5,1,1,1,6,1,6,6,7,6,2,2,1,3,3,2,3,1.666666667,2.75,3.46,2.5,6.25,2.13,3.75,"4,3,3,5,4,3,3,5",4,3,3,5,4,3,3,5,"Feminino",24,"Pardo","Homossexual","Solteiro(a)","Jaru","Sim","UPAP","Graduação",10
"94","inThreat",62,"fe83e2d0-df61-11eb-bf23-972ef7bdc96c",1625689168344,1625689615181,"stFemale",6.40312423743285,3.333333333,"3,1,4,3,4,3,3,4,5",3,1,4,3,4,3,3,4,5,"3, 5, 3, 2, 5, 4",3,5,3,2,5,4,4,2.67,"5,4,4,2,5,5,2,4,2,2,3,3,2,7,6,6,5",5,4,4,2,5,5,2,4,2,2,3,3,2,7,6,6,5,2.666666667,6,2.33,4.17,2.5,4.83,4.5,"4,4,5,5,5,4,5,4",4,4,5,5,5,4,5,4,"Masculino",19,"Negro","Heterossexual","Solteiro(a)","Rio Largo","Sim","UFAL","Graduação",2024
"97","inThreat",71,"9f602740-df62-11eb-bf23-972ef7bdc96c",1625689293969,1625689911040,"stFemale",7.81024967590665,3.555555556,"4,3,4,3,5,4,2,3,4",4,3,4,3,5,4,2,3,4,"4, 4, 2, 3, 5, 3",4,4,2,3,5,3,6,3,"5,5,6,3,6,6,3,4,6,3,3,2,2,4,5,5,4",5,5,6,3,6,6,3,4,6,3,3,2,2,4,5,5,4,2.333333333,4.5,2.92,5.17,4,4.58,4,"4,4,3,5,5,3,3,5",4,4,3,5,5,3,3,5,"Masculino",19,"Pardo","Heterossexual","Casado(a)","Luziápolis (Campo Alegre)","Sim","UFAL","Graduação",2024
"98","inThreat",72,"a2018610-df62-11eb-bf23-972ef7bdc96c",1625689305045,1625689848846,"stFemale",8.42614977317636,3.222222222,"4,2,2,3,5,1,2,5,5",4,2,2,3,5,1,2,5,5,"4, 5, 3, 4, 5, 5",4,5,3,4,5,5,3,3.67,"6,5,6,5,7,4,4,6,3,5,4,5,3,4,4,4,6",6,5,6,5,7,4,4,6,3,5,4,5,3,4,4,4,6,4,4.5,3.75,5.5,4.5,4.5,2.875,"5,1,3,1,3,4,2,4",5,1,3,1,3,4,2,4,"Masculino",19,"Branco","Heterossexual","Solteiro(a)","Maceió","Sim","UFAL","Graduação",NA
"99","inThreat",79,"32195750-df63-11eb-bf23-972ef7bdc96c",1625689170370,1625690146146,"stFemale",4.58257569495584,3.111111111,"3,2,3,4,3,3,2,4,4",3,2,3,4,3,3,2,4,4,"2, 5, 2, 3, 5, 5",2,5,2,3,5,5,3,2.33,"2,2,5,1,5,5,2,4,5,4,2,2,2,4,4,4,4",2,2,5,1,5,5,2,4,5,4,2,2,2,4,4,4,4,2,4,3,3.33,3.75,3.79,3.875,"4,3,4,5,5,3,3,4",4,3,4,5,5,3,3,4,"Masculino",19,"Branco","Heterossexual","Solteiro(a)","Maceió","Sim","UFAL","Graduação",2024
"101","inThreat",86,"e6b9afe0-efb5-11eb-991d-7bf2f9a6c3b9",1627484618181,1627484929765,"stFemale",7.14142842854285,3.777777778,"4,3,3,5,3,4,3,4,5",4,3,3,5,3,4,3,4,5,"3, 4, 4, 3, 4, 3",3,4,4,3,4,3,7,3.33,"1,1,1,1,2,2,6,6,4,,1,1,1,4,4,4,5",1,1,1,1,2,2,6,6,4,NA,1,1,1,4,4,4,5,1,4.25,2.38,1.33,5.33,2,3.75,"4,3,5,3,4,4,3,4",4,3,5,3,4,4,3,4,"Masculino",20,"Pardo","Heterossexual","Solteiro(a)","Arapiraca","Sim","UFAL","Graduação",2024
"102","inThreat",88,"2d313ce0-efb6-11eb-991d-7bf2f9a6c3b9",1627484586441,1627485001456,"stMale",7.14142842854285,3.666666667,"4,4,4,4,4,4,4,1,4",4,4,4,4,4,4,4,1,4,"4, 2, 5, 5, 2, 2",4,2,5,5,2,2,12,4.67,"3,2,2,2,6,2,6,2,6,6,2,2,2,4,4,4,4",3,2,2,2,6,2,6,2,6,6,2,2,2,4,4,4,4,2,4,3,2.83,5,2.92,3.375,"3,5,4,1,3,3,4,4",3,5,4,1,3,3,4,4,"Feminino",24,"Branco","Bissexual","Solteiro(a)","Maceió","Sim","UFAL","Graduação",2023
"103","inThreat",89,"56024dd0-efb6-11eb-991d-7bf2f9a6c3b9",1627484536763,1627485096105,"stMale",6.40312423743285,4,"4,4,5,5,4,3,2,5,4",4,4,5,5,4,3,2,5,4,"5, 4, 5, 5, 5, 4",5,4,5,5,5,4,5,5,"1,1,2,1,2,1,7,7,7,7,1,1,,6,5,5,6",1,1,2,1,2,1,7,7,7,7,1,1,NA,6,5,5,6,1,5.5,1.75,1.33,7,1.17,4.5,"5,5,5,2,5,5,4,5",5,5,5,2,5,5,4,5,"Feminino",23,"Pardo","Heterossexual","Casado(a)","Maceio","Sim","Ufal","Graduação",0
"104","inThreat",90,"86f372c0-efb6-11eb-991d-7bf2f9a6c3b9",1627484572328,1627485050341,"stMale",9.53939201416946,2.888888889,"3,1,3,4,3,3,2,4,3",3,1,3,4,3,3,2,4,3,"3, 5, 1, 1, 5, 3",3,5,1,1,5,3,5,1.67,"4,2,5,1,7,2,3,4,1,1,4,2,1,,1,1,1",4,2,5,1,7,2,3,4,1,1,4,2,1,NA,1,1,1,2.333333333,1,4.67,3.5,2.25,4.63,3.125,"3,5,2,3,5,2,1,4",3,5,2,3,5,2,1,4,"Feminino",21,"Pardo","Bissexual","Solteiro(a)","Maceió","Sim","UFAL","Graduação",2023
"105","inThreat",92,"d7092840-efb6-11eb-991d-7bf2f9a6c3b9",1627484824190,1627485311088,"stMale",7.14142842854285,3.222222222,"4,4,2,3,2,2,5,5,2",4,4,2,3,2,2,5,5,2,"2, 3, 3, 2, 1, 1",2,3,3,2,1,1,13,2.33,"7,6,7,2,7,4,2,7,2,2,6,6,4,2,3,2,1",7,6,7,2,7,4,2,7,2,2,6,6,4,2,3,2,1,5.333333333,2,5.67,5.5,3.25,5.13,2.5,"2,3,3,5,1,2,1,3",2,3,3,5,1,2,1,3,"Feminino",19,"Negro","Bissexual","Solteiro(a)","Alagoas","Sim","ufal","Graduação",2023
"106","inThreat",95,"084deb70-efb7-11eb-991d-7bf2f9a6c3b9",1627484631668,1627485351806,"stFemale",7.14142842854285,3.111111111,"3,2,4,3,4,4,4,1,3",3,2,4,3,4,4,4,1,3,"2, 5, 4, 1, 4, 4",2,5,4,1,4,4,5,2.33,"1,1,1,1,1,1,6,6,6,6,3,3,1,4,4,4,6",1,1,1,1,1,1,6,6,6,6,3,3,1,4,4,4,6,2.333333333,4.5,2.92,1,6,1.5,3.625,"4,4,4,1,5,4,3,4",4,4,4,1,5,4,3,4,"Masculino",30,"Pardo","Bissexual","Solteiro(a)","Maceió","Sim","UFAL","Graduação",2024
"107","inThreat",96,"17469f50-efb7-11eb-991d-7bf2f9a6c3b9",1627484632557,1627485400814,"stMale",7.81024967590665,2.666666667,"3,2,3,3,3,2,1,4,3",3,2,3,3,3,2,1,4,3,"3, 5, 2, 2, 5, 5",3,5,2,2,5,5,3,2.33,"3,2,3,1,5,2,4,4,5,3,2,2,1,3,3,2,4",3,2,3,1,5,2,4,4,5,3,2,2,1,3,3,2,4,1.666666667,3,3.33,2.67,4,3.33,3,"4,3,3,2,4,3,2,3",4,3,3,2,4,3,2,3,"Feminino",20,"Branco","Heterossexual","Solteiro(a)","","Sim","UFAL","Graduação",NA
