"","testType","gender","X","responseId","startTime","endTime","activityPoints","dfs","dfsItens","dfs01","dfs02","dfs03","dfs04","dfs05","dfs06","dfs07","dfs08","dfs09","dejectionPre2","FR01","FR04","FR03","FR10","FR02","FR06","prevention.pre","promotion.pre","dejectionPost","tense","nervous","anxious","depressed","uncertain","agitated","calm","self_conscious","quiet","unconcerned","disappointed","frustrated","sad","contented","enthusiastic","happy","balanced","dejection","cheerfulness","promotion.pos","agitation","quiescence","prevention.pos","fss","flow","flow01","flow02","flow03","flow04","flow05","flow06","flow07","flow08","Condition","age","ethnicity","sexualOrientation","civilState","city","universityEducation","institucion","educationLevel","conclusion"
"1","default","Feminino",10,"bb421410-9e34-11eb-9b7e-0daf340a71ab",1618526737811,1618527015960,11.4727355867823,3.625,"3,3,5,2,5,5,1,,5",3,3,5,2,5,5,1,NA,5,"5, 5, 5, 3, 5, 3",5,5,5,3,5,3,5,4.33,"1,1,1,1,1,1,7,7,7,7,3,1,1,7,7,7,7",1,1,1,1,1,1,7,7,7,7,3,1,1,7,7,7,7,1.666666667,7,1.33,1,7,1,5,"5,5,5,5,5,5,5,5",5,5,5,5,5,5,5,5,"control",17,"Branco","Heterossexual","Solteiro(a)","","Não","","",NA
"2","default","Feminino",11,"46f906c0-9e36-11eb-9b7e-0daf340a71ab",1618523754311,1618524035226,11.4727355867823,3.888888889,"4,3,5,4,3,3,5,5,3",4,3,5,4,3,3,5,5,3,"2, 2, 3, 3, 5, 1",2,2,3,3,5,1,10,2.67,"1,2,1,1,6,6,1,1,1,1,3,5,3,3,1,1,1",1,2,1,1,6,6,1,1,1,1,3,5,3,3,1,1,1,3.666666667,1.5,5.08,2.83,1,4.92,1.875,"4,4,1,2,1,1,1,1",4,4,1,2,1,1,1,1,"control",24,"Pardo","Heterossexual","Solteiro(a)","Maceió","Sim","UFAL","Graduação",2024
"3","default","Feminino",17,"a4947eb0-a456-11eb-8cbb-599e427a3fce",1619197004062,1619197615203,5.56776436283002,4.444444444,"4,4,4,5,4,5,4,5,5",4,4,4,5,4,5,4,5,5,"3, 4, 4, 5, 5, 5",3,4,4,5,5,5,4,4,"1,1,3,1,3,1,6,6,4,6,2,3,1,5,5,4,6",1,1,3,1,3,1,6,6,4,6,2,3,1,5,5,4,6,2,5,2.5,1.67,5.5,2.08,4.75,"5,5,5,5,5,4,5,4",5,5,5,5,5,4,5,4,"control",29,"Branco","Heterossexual","Solteiro(a)","Jandira","Sim","Universidade de São Paulo","Graduação",2022
"4","default","Feminino",28,"da329100-aeb6-11eb-8cbb-599e427a3fce",1620337827048,1620338354837,6.40312423743285,3.444444444,"4,2,4,3,4,2,4,3,5",4,2,4,3,4,2,4,3,5,"3, 5, 4, 4, 2, 3",3,5,4,4,2,3,8,3.67,"1,1,2,1,4,1,5,5,4,5,2,2,1,5,5,4,5",1,1,2,1,4,1,5,5,4,5,2,2,1,5,5,4,5,1.666666667,4.75,2.46,1.67,4.75,2.46,3.375,"3,5,3,1,4,3,3,5",3,5,3,1,4,3,3,5,"control",22,"Pardo","Heterossexual","Solteiro(a)","Maceió","Sim","UFAL","Graduação",2022
"5","default","Feminino",33,"5ca44270-b19e-11eb-b944-15c8c1c6ce71",1620657461650,1620657859299,11.4727355867823,3.888888889,"3,5,5,5,3,3,1,5,5",3,5,5,5,3,3,1,5,5,"2, 5, 5, 5, 5, 5",2,5,5,5,5,5,3,4,"1,,7,7,7,7,3,6,1,7,7,7,7,7,7,1,1",1,NA,7,7,7,7,3,6,1,7,7,7,7,7,7,1,1,7,4,5.5,5.8,4.25,4.78,3,"2,5,3,5,2,2,2,3",2,5,3,5,2,2,2,3,"control",21,"Pardo","Heterossexual","Solteiro(a)","","Sim","Ufal","Graduação",2025
"6","default","Feminino",34,"c5d98fb0-b1c7-11eb-b944-15c8c1c6ce71",1620674228832,1620675578697,6.40312423743285,3.444444444,"4,1,4,5,3,4,4,2,4",4,1,4,5,3,4,4,2,4,"3, 4, 4, 4, 3, 2",3,4,4,4,3,2,9,3.67,"1,1,1,1,4,1,4,4,4,5,1,1,1,1,1,1,6",1,1,1,1,4,1,4,4,4,5,1,1,1,1,1,1,6,1,2.25,3.38,1.5,4.25,2.63,3.125,"5,2,4,1,4,4,3,2",5,2,4,1,4,4,3,2,"control",19,"Branco","Heterossexual","Prefiro não Responder","Maceió","Sim","UFAL","Graduação",2024
"7","default","Feminino",46,"92d0f4f0-b834-11eb-93e6-43229aa359ae",1621381184774,1621382048968,8.42614977317636,3.555555556,"4,3,4,3,3,3,3,5,4",4,3,4,3,3,3,3,5,4,"2, 4, 4, 3, 4, 4",2,4,4,3,4,4,6,3,"6,5,6,4,7,5,2,4,1,2,4,2,3,2,2,1,1",6,5,6,4,7,5,2,4,1,2,4,2,3,2,2,1,1,3,1.5,4.75,5.5,2.25,5.63,2.25,"2,3,2,5,2,1,1,2",2,3,2,5,2,1,1,2,"control",23,"Negro","Prefiro não Responder","Solteiro(a)","Maceió","Sim","UFAL","Graduação",2025
"8","default","Feminino",53,"fc1e63c0-dbac-11eb-916d-ef9a5fc9a834",1625280266099,1625281729259,7.14142842854285,2.555555556,"3,2,4,2,2,1,2,4,3",3,2,4,2,2,1,2,4,3,"3, 4, 3, 3, 5, 4",3,4,3,3,5,4,5,3,"1,1,3,1,5,1,5,7,6,6,6,6,2,2,3,2,6",1,1,3,1,5,1,5,7,6,6,6,6,2,2,3,2,6,4.666666667,3.25,4.71,2,6,2,3.625,"4,4,4,1,5,5,4,2",4,4,4,1,5,5,4,2,"control",19,"Negro","Heterossexual","Solteiro(a)","Paripueira","Sim","UFAL","Graduação",2025
"9","default","Feminino",54,"b7ecef30-dbf9-11eb-916d-ef9a5fc9a834",1625314435990,1625314990128,5.56776436283002,3.333333333,"3,3,4,4,3,4,3,2,4",3,3,4,4,3,4,3,2,4,"4, 3, 4, 3, 2, 2",4,3,4,3,2,2,11,3.67,"1,1,1,1,2,1,7,7,7,7,1,1,1,4,4,4,7",1,1,1,1,2,1,7,7,7,7,1,1,1,4,4,4,7,1,4.75,2.13,1.17,7,1.08,3.75,"4,5,5,1,3,3,4,5",4,5,5,1,3,3,4,5,"control",20,"Pardo","Heterossexual","Solteiro(a)","Salvador","Sim","UFAL","Graduação",2023
"10","default","Feminino",73,"ba97c630-df62-11eb-bf23-972ef7bdc96c",1625689268522,1625689939274,5.56776436283002,3.222222222,"1,2,4,3,4,5,5,2,3",1,2,4,3,4,5,5,2,3,"2, 5, 4, 3, 5, 4",2,5,4,3,5,4,4,3,"3,3,1,1,4,1,6,7,7,6,2,1,1,4,2,4,7",3,3,1,1,4,1,6,7,7,6,2,1,1,4,2,4,7,1.333333333,4.25,2.54,2.17,6.5,1.83,4.25,"5,4,5,1,5,5,5,4",5,4,5,1,5,5,5,4,"control",19,"Branco","Heterossexual","Solteiro(a)","barreiros-Pe","Sim","ufal","Graduação",2024
"11","default","Feminino",91,"9dff1b40-efb6-11eb-991d-7bf2f9a6c3b9",1627484617000,1627485093751,9.53939201416946,2.777777778,"3,2,3,3,3,2,3,3,3",3,2,3,3,3,2,3,3,3,"2, 2, 3, 2, 3, 3",2,2,3,2,3,3,10,2.33,"3,3,6,2,6,6,2,3,1,3,4,4,4,5,4,3,3",3,3,6,2,6,6,2,3,1,3,4,4,4,5,4,3,3,4,3.75,4.13,4.33,2.25,5.04,2.25,"3,1,2,2,2,3,2,3",3,1,2,2,2,3,2,3,"control",22,"Pardo","Heterossexual","Solteiro(a)","Maceió-AL","Sim","Universidade Federal de Alagoas","Graduação",2023
"12","default","Feminino",93,"ee21a200-efb6-11eb-991d-7bf2f9a6c3b9",1627484599157,1627485261850,8.42614977317636,2.666666667,"2,2,3,2,3,3,1,4,4",2,2,3,2,3,3,1,4,4,"3, 4, 3, 4, 5, 3",3,4,3,4,5,3,6,3.33,"4,2,5,2,7,6,2,4,2,2,4,6,3,2,2,1,2",4,2,5,2,7,6,2,4,2,2,4,6,3,2,2,1,2,4.333333333,1.75,5.29,4.33,2.5,4.92,2.625,"2,1,2,4,4,2,2,4",2,1,2,4,4,2,2,4,"control",20,"Branco","Prefiro não Responder","Solteiro(a)","Maceió","Sim","UFAL","Graduação",3
"13","default","Feminino",98,"b42f8980-efb7-11eb-991d-7bf2f9a6c3b9",1627484809094,1627485542755,6.40312423743285,3,"4,3,4,2,2,2,3,4,3",4,3,4,2,2,2,3,4,3,"4, 2, 3, 2, 2, 2",4,2,3,2,2,2,12,3,"5,4,6,3,6,5,2,5,3,1,4,2,1,3,2,2,3",5,4,6,3,6,5,2,5,3,1,4,2,1,3,2,2,3,2.333333333,2.5,3.92,4.83,2.75,5.04,2.625,"2,2,2,5,3,2,1,4",2,2,2,5,3,2,1,4,"control",23,"Branco","Pansexual","Solteiro(a)","Maceió","Sim","UFAL","Graduação",2024
"14","default","Feminino",99,"15067de0-efb8-11eb-991d-7bf2f9a6c3b9",1627484795648,1627485763133,7.81024967590665,3.333333333,"3,2,3,3,5,3,3,5,3",3,2,3,3,5,3,3,5,3,"3, 4, 3, 1, 5, 4",3,4,3,1,5,4,5,2.33,"3,1,1,1,7,1,5,5,5,4,5,5,1,1,1,1,3",3,1,1,1,7,1,5,5,5,4,5,5,1,1,1,1,3,3.666666667,1.5,5.08,2.33,4.75,2.79,2.5,"3,3,2,4,1,1,1,5",3,3,2,4,1,1,1,5,"control",19,"Branco","Heterossexual","Solteiro(a)","Maceió","Sim","ufal","Graduação",2023
"15","default","Feminino",101,"5ad35650-f6e7-11eb-991d-7bf2f9a6c3b9",1628275217396,1628275734261,10.0498756211209,2.888888889,"3,1,3,3,3,3,4,3,3",3,1,3,3,3,3,4,3,3,"2, 4, 3, 2, 5, 2",2,4,3,2,5,2,7,2.33,"2,1,2,2,3,2,2,3,2,1,2,2,1,3,3,2,3",2,1,2,2,3,2,2,3,2,1,2,2,1,3,3,2,3,1.666666667,2.75,3.46,2,2,4,3.5,"4,3,3,3,4,4,3,4",4,3,3,3,4,4,3,4,"control",22,"Negro","Heterossexual","Solteiro(a)","Maceió","Sim","UFAL","Graduação",3
"16","default","Masculino",6,"18379910-9df4-11eb-9b7e-0daf340a71ab",1618494713997,1618495449457,6.40312423743285,3,"3,3,4,2,2,3,2,4,4",3,3,4,2,2,3,2,4,4,"4, 5, 3, 3, 4, 2",4,5,3,3,4,2,7,3.33,"4,2,2,2,4,1,5,5,5,2,1,1,1,5,2,4,5",4,2,2,2,4,1,5,5,5,2,1,1,1,5,2,4,5,1,4,2.5,2.5,4.25,3.13,3.5,"4,4,2,2,4,5,2,5",4,4,2,2,4,5,2,5,"control",23,"Branco","Heterossexual","Solteiro(a)","Maceió","Sim","UFAL","Graduação",2023
"17","default","Masculino",7,"4b9fd020-9e02-11eb-9b7e-0daf340a71ab",1618501325522,1618501732613,7.81024967590665,4.777777778,"5,4,5,5,4,5,5,5,5",5,4,5,5,4,5,5,5,5,"4, 5, 5, 5, 5, 4",4,5,5,5,5,4,4,4.67,"5,5,7,1,4,4,3,5,5,1,1,1,1,4,4,1,1",5,5,7,1,4,4,3,5,5,1,1,1,1,4,4,1,1,1,2.5,3.25,4.33,3.5,4.42,2.625,"5,1,1,5,1,1,3,4",5,1,1,5,1,1,3,4,"control",22,"Pardo","Heterossexual","Solteiro(a)","maceió","Sim","unit","Graduação",2021
"18","default","Masculino",15,"7ac290a0-a437-11eb-8cbb-599e427a3fce",1619183733777,1619184236905,7.81024967590665,3.555555556,"3,3,4,5,3,3,5,3,3",3,3,4,5,3,3,5,3,3,"3, 4, 2, 2, 4, 4",3,4,2,2,4,4,6,2.33,"5,3,5,1,5,4,3,7,5,7,4,4,1,2,4,4,3",5,3,5,1,5,4,3,7,5,7,4,4,1,2,4,4,3,3,3.25,3.88,3.83,5.5,3.17,3.625,"4,5,3,3,4,3,3,4",4,5,3,3,4,3,3,4,"control",54,"Pardo","Heterossexual","Casado(a)","Alfenas","Sim","UFOP","Mestrado",2021
"19","default","Masculino",20,"eb7bfbc0-a79c-11eb-8cbb-599e427a3fce",1619557311077,1619557707080,5.56776436283002,3.333333333,"4,3,4,4,2,3,2,4,4",4,3,4,4,2,3,2,4,4,"3, 5, 3, 2, 5, 4",3,5,3,2,5,4,4,2.67,"2,2,2,2,3,1,5,6,4,4,3,2,2,4,3,,5",2,2,2,2,3,1,5,6,4,4,3,2,2,4,3,NA,5,2.333333333,4,3.17,2,4.75,2.63,3.375,"4,5,4,2,3,4,2,3",4,5,4,2,3,4,2,3,"control",23,"Branco","Heterossexual","Solteiro(a)","Campo Grande","Sim","Universidade Federal do Mato Grosso do Sul","Graduação",2022
"20","default","Masculino",21,"d7506eb0-a81e-11eb-8cbb-599e427a3fce",1619612894550,1619613468097,5.56776436283002,3.666666667,"4,4,2,5,1,3,4,5,5",4,4,2,5,1,3,4,5,5,"4, 5, 3, 2, 5, 5",4,5,3,2,5,5,3,3,"1,2,1,1,4,6,3,6,1,4,5,5,5,2,6,6,7",1,2,1,1,4,6,3,6,1,4,5,5,5,2,6,6,7,5,5.25,3.88,2.5,3.5,3.5,3.75,"5,2,2,5,5,4,3,4",5,2,2,5,5,4,3,4,"control",24,"Branco","Heterossexual","Solteiro(a)","Campo Grande","Sim","UFMS","Graduação",NA
"21","default","Masculino",26,"d1fc0bc0-a848-11eb-8cbb-599e427a3fce",1619630821705,1619631258387,9,2.888888889,"2,4,4,2,2,1,5,5,1",2,4,4,2,2,1,5,5,1,"4, 5, 5, 5, 5, 5",4,5,5,5,5,5,3,4.67,"5,5,5,1,6,1,5,5,5,1,3,3,1,2,4,2,4",5,5,5,1,6,1,5,5,5,1,3,3,1,2,4,2,4,2.333333333,3,3.67,3.83,4,3.92,4.625,"4,5,5,5,5,5,5,3",4,5,5,5,5,5,5,3,"control",23,"Pardo","Homossexual","Solteiro(a)","CAMPO GRANDE","Sim","UFMS","Graduação",2023
"22","default","Masculino",27,"a9467110-a853-11eb-8cbb-599e427a3fce",1619635076676,1619636139028,3.75970760696555,2.333333333,"3,2,2,3,1,1,1,5,3",3,2,2,3,1,1,1,5,3,"1, 1, 1, 1, 5, 2",1,1,1,1,5,2,10,1,"2,2,2,1,5,4,6,6,6,6,1,1,1,1,1,1,2",2,2,2,1,5,4,6,6,6,6,1,1,1,1,1,1,2,1,1.25,3.88,2.67,6,2.33,3.375,"5,5,3,2,1,3,3,5",5,5,3,2,1,3,3,5,"control",19,"Branco","Bissexual","Solteiro(a)","Campo Grande","Sim","UFMS","Graduação",2024
"23","default","Masculino",31,"e7bb7ec0-b057-11eb-b944-15c8c1c6ce71",1620517330346,1620517608178,9.35060480921015,3.4,",,,,1,3,5,4,4",NA,NA,NA,NA,1,3,5,4,4,"3, 3, 3, 3, 3, 3",3,3,3,3,3,3,9,3,"1,1,1,1,1,1,6,6,6,6,1,1,1,4,4,6,6",1,1,1,1,1,1,6,6,6,6,1,1,1,4,4,6,6,1,5,2,1,6,1.5,4,"5,5,5,5,3,3,3,3",5,5,5,5,3,3,3,3,"control",30,"Branco","Heterossexual","Solteiro(a)","Cuiabá","Sim","Ufmt","Graduação",2025
"24","default","Masculino",36,"16027280-b1dd-11eb-b944-15c8c1c6ce71",1620683621288,1620684627288,4.58257569495584,3.777777778,"5,3,4,4,5,4,4,2,3",5,3,4,4,5,4,4,2,3,"4, 3, 2, 4, 3, 3",4,3,2,4,3,3,9,3.33,"4,2,2,1,3,2,6,6,6,5,1,2,1,6,2,5,7",4,2,2,1,3,2,6,6,6,5,1,2,1,6,2,5,7,1.333333333,5,2.17,2.33,5.75,2.29,4.25,"5,4,5,2,5,4,4,5",5,4,5,2,5,4,4,5,"control",24,"Pardo","Heterossexual","Solteiro(a)","Brasília","Sim","Universidade de Brasília","Graduação",2022
"25","default","Masculino",37,"8eba26c0-b1ea-11eb-b944-15c8c1c6ce71",1620690086378,1620690468124,5.56776436283002,2.888888889,"3,2,2,4,5,2,2,3,3",3,2,2,4,5,2,2,3,3,"2, 5, 3, 2, 4, 3",2,5,3,2,4,3,6,2.33,"1,1,1,1,3,1,4,4,4,6,2,1,1,1,2,1,4",1,1,1,1,3,1,4,4,4,6,2,1,1,1,2,1,4,1.333333333,2,3.67,1.33,4.5,2.42,2.75,"5,5,3,1,1,2,2,3",5,5,3,1,1,2,2,3,"control",19,"Branco","Assexual","Solteiro(a)","Brasília","Sim","Universidade de Brasília","Graduação",2026
"26","default","Masculino",38,"3cbe7e50-b25a-11eb-b944-15c8c1c6ce71",1620738047180,1620738541480,7.14142842854285,4.111111111,"5,4,5,4,4,3,3,5,4",5,4,5,4,4,3,3,5,4,"4, 4, 4, 2, 5, 5",4,4,4,2,5,5,4,3.33,"1,1,1,1,2,1,7,7,1,1,1,1,1,5,6,4,7",1,1,1,1,2,1,7,7,1,1,1,1,1,5,6,4,7,1,5.5,1.75,1.17,4,2.58,4,"5,1,5,4,5,5,4,3",5,1,5,4,5,5,4,3,"control",23,"Branco","Heterossexual","Solteiro(a)","Paranoá","Sim","Universidade de Brasilia","Graduação",2022
"27","default","Masculino",40,"108b6210-b649-11eb-ad27-3593da35795f",1621169857497,1621170870685,5.56776436283002,4.888888889,"5,5,5,5,5,5,5,4,5",5,5,5,5,5,5,5,4,5,"4, 5, 4, 5, 5, 3",4,5,4,5,5,3,5,4.33,"1,1,1,1,2,1,7,7,6,1,1,1,1,7,2,7,7",1,1,1,1,2,1,7,7,6,1,1,1,1,7,2,7,7,1,5.75,1.63,1.17,5.25,1.96,4.5,"5,5,5,1,5,5,5,5",5,5,5,1,5,5,5,5,"control",27,"Negro","Heterossexual","Solteiro(a)","BRASILIA","Sim","universidade de brasília","Graduação",20222
"28","default","Masculino",48,"b86c5a00-c0be-11eb-93e6-43229aa359ae",1622320344479,1622320983017,4.58257569495584,3.222222222,"3,3,4,4,3,3,5,2,2",3,3,4,4,3,3,5,2,2,"4, 4, 3, 4, 5, 4",4,4,3,4,5,4,5,3.67,"2,2,2,2,3,3,6,7,6,6,3,3,1,6,5,5,6",2,2,2,2,3,3,6,7,6,6,3,3,1,6,5,5,6,2.333333333,5.5,2.42,2.33,6.25,2.04,4.25,"5,4,5,1,5,4,5,5",5,4,5,1,5,4,5,5,"control",23,"Branco","Heterossexual","Solteiro(a)","Maceió - AL","Sim","UFPE","Graduação",2023
"29","default","Masculino",55,"4ca8d3a0-dc27-11eb-916d-ef9a5fc9a834",1625334003218,1625334563305,6.40312423743285,3.222222222,"4,2,4,3,1,3,4,5,3",4,2,4,3,1,3,4,5,3,"3, 2, 4, 2, 5, 3",3,2,4,2,5,3,8,3,"1,1,2,2,3,1,4,5,3,6,2,1,1,3,4,2,4",1,1,2,2,3,1,4,5,3,6,2,1,1,3,4,2,4,1.333333333,3.25,3.04,1.67,4.5,2.58,3.875,"4,5,3,5,5,5,2,2",4,5,3,5,5,5,2,2,"control",21,"Negro","Heterossexual","Solteiro(a)","Coruripe","Sim","Instituto da Computação","Graduação",2025
"30","default","Masculino",57,"c2104500-df61-11eb-bf23-972ef7bdc96c",1625689144337,1625689576895,9,3.666666667,"3,2,5,3,4,3,5,4,4",3,2,5,3,4,3,5,4,4,"3, 5, 3, 4, 5, 3",3,5,3,4,5,3,5,3.33,"2,2,3,2,5,1,4,4,3,2,3,2,,4,3,4,4",2,2,3,2,5,1,4,4,3,2,3,2,NA,4,3,4,4,2.5,3.75,3.38,2.5,3.25,3.63,3.25,"4,5,3,2,4,3,3,2",4,5,3,2,4,3,3,2,"control",18,"Pardo","Heterossexual","Solteiro(a)","Rio Largo","Sim","UFAL","Graduação",2023
"31","default","Masculino",59,"eacce390-df61-11eb-bf23-972ef7bdc96c",1625689128108,1625689604033,6.40312423743285,3.666666667,"3,1,5,4,5,3,5,2,5",3,1,5,4,5,3,5,2,5,"3, 3, 3, 5, 5, 4",3,3,3,5,5,4,6,3.67,"2,2,4,2,5,4,6,6,5,5,2,1,1,7,6,6,7",2,2,4,2,5,4,6,6,5,5,2,1,1,7,6,6,7,1.333333333,6.5,1.42,3.17,5.5,2.83,4.125,"4,5,5,1,4,4,5,5",4,5,5,1,4,4,5,5,"control",18,"Pardo","Heterossexual","Solteiro(a)","Maceio","Sim","UFAL","Graduação",2026
"32","default","Masculino",63,"369d0020-df62-11eb-bf23-972ef7bdc96c",1625689236446,1625689724073,7.81024967590665,3.444444444,"3,2,4,3,4,3,2,5,5",3,2,4,3,4,3,2,5,5,"3, 5, 4, 4, 5, 4",3,5,4,4,5,4,4,3.67,"4,2,6,1,6,6,2,4,3,3,1,1,1,6,6,6,5",4,2,6,1,6,6,2,4,3,3,1,1,1,6,6,6,5,1,5.75,1.63,4.17,3,4.58,4.125,"5,2,3,4,5,5,4,5",5,2,3,4,5,5,4,5,"control",19,"Branco","Heterossexual","Solteiro(a)","Maceió","Sim","UFAL","Graduação",2025
"33","default","Masculino",64,"3ee27670-df62-11eb-bf23-972ef7bdc96c",1625689186996,1625689720011,6.40312423743285,3.555555556,"4,2,3,3,4,3,5,5,3",4,2,3,3,4,3,5,5,3,"2, 5, 3, 4, 4, 3",2,5,3,4,4,3,6,3,"1,1,1,1,6,1,7,6,7,6,1,1,1,6,6,6,7",1,1,1,1,6,1,7,6,7,6,1,1,1,6,6,6,7,1,6.25,1.38,1.83,6.5,1.67,4.625,"5,5,4,5,5,4,4,5",5,5,4,5,5,4,4,5,"control",19,"Pardo","Heterossexual","Solteiro(a)","Maceió - AL","Sim","UFAL","Graduação",2025
"34","default","Masculino",66,"4807c570-df62-11eb-bf23-972ef7bdc96c",1625689305171,1625689740431,7.14142842854285,2.555555556,"3,2,3,2,2,2,2,4,3",3,2,3,2,2,2,2,4,3,"4, 4, 3, 3, 5, 4",4,4,3,3,5,4,5,3.33,"2,2,3,2,4,3,5,6,3,6,2,1,2,4,2,2,7",2,2,3,2,4,3,5,6,3,6,2,1,2,4,2,2,7,1.666666667,3.75,2.96,2.67,5,2.83,3.875,"5,5,4,3,3,4,3,4",5,5,4,3,3,4,3,4,"control",20,"Pardo","Heterossexual","Solteiro(a)","Maceió","Sim","Ufal","Graduação",2023
"35","default","Masculino",69,"890928c0-df62-11eb-bf23-972ef7bdc96c",1625689172640,1625689869152,5.56776436283002,4.222222222,"4,4,4,4,5,4,5,4,4",4,4,4,4,5,4,5,4,4,"4, 3, 4, 4, 3, 3",4,3,4,4,3,3,9,4,"5,4,4,2,5,4,6,6,5,6,3,2,2,5,6,5,6",5,4,4,2,5,4,6,6,5,6,3,2,2,5,6,5,6,2.333333333,5.5,2.42,4,5.75,3.13,3.75,"4,4,4,4,4,3,3,4",4,4,4,4,4,3,3,4,"control",20,"Branco","Heterossexual","Solteiro(a)","Maceió","Sim","UFAL","Graduação",2023
"36","default","Masculino",70,"9bf2ecf0-df62-11eb-bf23-972ef7bdc96c",1625689257833,1625689859604,9,2.111111111,"3,2,1,1,1,1,1,5,4",3,2,1,1,1,1,1,5,4,"5, 5, 1, 1, 5, 1",5,5,1,1,5,1,7,2.33,"7,7,7,1,7,7,1,1,1,1,1,1,1,7,7,7,1",7,7,7,1,7,7,1,1,1,1,1,1,1,7,7,7,1,1,5.5,1.75,6,1,6.5,2,"1,1,1,5,1,1,5,1",1,1,1,5,1,1,5,1,"control",20,"Pardo","Heterossexual","Solteiro(a)","Maceió","Sim","Universidade Federal de Alagoas - UFAL","Graduação",2024
"37","default","Masculino",77,"2145a1e0-df63-11eb-bf23-972ef7bdc96c",1625689122808,1625689973314,3.75970760696555,4,"4,3,4,4,4,5,5,4,3",4,3,4,4,4,5,5,4,3,"5, 5, 4, 3, 5, 5",5,5,4,3,5,5,3,4,"1,1,1,1,2,1,7,7,5,6,1,1,1,7,6,5,7",1,1,1,1,2,1,7,7,5,6,1,1,1,7,6,5,7,1,6.25,1.38,1.17,6.25,1.46,4.75,"5,5,5,3,5,5,5,5",5,5,5,3,5,5,5,5,"control",24,"Pardo","Heterossexual","Casado(a)","Maceió","Sim","UFAL","Graduação",2025
"38","default","Masculino",81,"d9957860-df63-11eb-bf23-972ef7bdc96c",1625689133155,1625690264637,6.40312423743285,2.666666667,"3,2,2,3,2,3,1,5,3",3,2,2,3,2,3,1,5,3,"3, 4, 2, 2, 4, 4",3,4,2,2,4,4,6,2.33,"4,3,6,3,5,5,3,5,3,4,4,5,3,4,4,4,3",4,3,6,3,5,5,3,5,3,4,4,5,3,4,4,4,3,4,3.75,4.13,4.33,3.75,4.29,3.25,"4,2,3,4,4,3,3,3",4,2,3,4,4,3,3,3,"control",23,"Pardo","Bissexual","Solteiro(a)","Marechal Deodoro","Sim","Ufal","Graduação",2023
"39","default","Masculino",84,"4aee3340-e657-11eb-aeff-859c71bd906c",1626454027888,1626454699593,5.56776436283002,3,"3,3,2,2,5,3,2,5,2",3,3,2,2,5,3,2,5,2,"3, 4, 1, 1, 5, 1",3,4,1,1,5,1,8,1.67,"1,1,1,1,3,7,7,7,7,2,4,1,1,5,6,3,4",1,1,1,1,3,7,7,7,7,2,4,1,1,5,6,3,4,2,4.5,2.75,2.33,5.75,2.29,3.125,"5,1,3,3,4,3,3,3",5,1,3,3,4,3,3,3,"control",23,"Branco","Heterossexual","Solteiro(a)","Arapiraca","Sim","Ufal","Graduação",2022
"40","default","Masculino",85,"2dbcb190-e682-11eb-aeff-859c71bd906c",1626472399273,1626473093231,5.56776436283002,2.444444444,"3,2,2,2,2,2,4,3,2",3,2,2,2,2,2,4,3,2,"2, 4, 3, 3, 5, 3",2,4,3,3,5,3,6,2.67,"3,5,5,2,6,3,4,5,5,3,2,2,2,5,4,5,4",3,5,5,2,6,3,4,5,5,3,2,2,2,5,4,5,4,2,4.5,2.75,4,4.25,3.88,4.375,"5,5,5,2,5,4,4,5",5,5,5,2,5,4,4,5,"control",21,"Branco","Heterossexual","Solteiro(a)","Arapiraca","Sim","UFAL","Graduação",2025
"41","default","Masculino",87,"00b46200-efb6-11eb-991d-7bf2f9a6c3b9",1627484553211,1627484904155,9.35060480921015,3.444444444,"4,3,4,4,3,3,3,3,4",4,3,4,4,3,3,3,3,4,"3, 4, 3, 3, 4, 4",3,4,3,3,4,4,6,3,"3,3,2,1,3,1,7,4,5,7,1,1,1,4,5,5,6",3,3,2,1,3,1,7,4,5,7,1,1,1,4,5,5,6,1,5,2,2.17,5.75,2.21,3.125,"3,5,3,2,2,3,3,4",3,5,3,2,2,3,3,4,"control",25,"Pardo","Heterossexual","Solteiro(a)","Penedo","Sim","Universidade Federal de Alagoas","Graduação",2023
"42","default","Masculino",97,"27025510-efb7-11eb-991d-7bf2f9a6c3b9",1627484550621,1627485385657,5.56776436283002,3.333333333,"3,3,4,3,3,3,4,4,3",3,3,4,3,3,3,4,4,3,"4, 2, 3, 3, 4, 2",4,2,3,3,4,2,10,3.33,"6,6,6,1,5,6,3,5,3,2,1,1,1,6,4,6,5",6,6,6,1,5,6,3,5,3,2,1,1,1,6,4,6,5,1,5.25,1.88,5,3.25,4.88,4,"4,5,4,3,4,4,3,5",4,5,4,3,4,4,3,5,"control",20,"Branco","Heterossexual","Solteiro(a)","Maceió","Sim","Universidade Federal de Alagoas","Graduação",2024
"43","default","Masculino",107,"9d1ee580-f6ea-11eb-991d-7bf2f9a6c3b9",1628276094117,1628277093893,6.40312423743285,3.666666667,"5,3,4,3,4,3,3,4,4",5,3,4,3,4,3,3,4,4,"3, 3, 4, 3, 4, 5",3,3,4,3,4,5,6,3.33,"5,1,3,1,2,1,2,6,2,2,1,1,1,6,6,6,6",5,1,3,1,2,1,2,6,2,2,1,1,1,6,6,6,6,1,6,1.5,2.17,3,3.58,4.125,"5,4,4,4,4,4,4,4",5,4,4,4,4,4,4,4,"control",22,"Pardo","Heterossexual","Solteiro(a)","ATALAIA","Sim","UFAL","Outros",2022
"44","stFemale","Feminino",4,"358e5340-9d4b-11eb-9b7e-0daf340a71ab",1618422301740,1618422916334,10.8167783030316,4,"3,3,4,5,5,3,5,5,3",3,3,4,5,5,3,5,5,3,"5, 1, 5, 1, 1, 1",5,1,5,1,1,1,15,3.67,"7,7,7,4,7,7,1,1,1,1,7,7,7,1,4,1,4",7,7,7,4,7,7,1,1,1,1,7,7,7,1,4,1,4,7,2.5,6.25,6.5,1,6.75,4,"5,5,5,5,5,3,1,3",5,5,5,5,5,3,1,3,"inBoost",48,"Negro","Homossexual","Solteiro(a)","","Sim","Ufal","Graduação",2025
"45","stFemale","Feminino",8,"169a9c00-9e22-11eb-9b7e-0daf340a71ab",1618514927197,1618515346194,10.5356537528527,2.555555556,"3,2,3,1,2,2,3,4,3",3,2,3,1,2,2,3,4,3,"4, 5, 5, 5, 5, 3",4,5,5,5,5,3,5,4.67,"5,5,5,1,7,7,1,7,2,2,4,3,1,3,3,3,3",5,5,5,1,7,7,1,7,2,2,4,3,1,3,3,3,3,2.666666667,3,3.83,5,3,5,2.75,"2,2,2,3,4,3,3,3",2,2,2,3,4,3,3,3,"inBoost",21,"Negro","Prefiro não Responder","Solteiro(a)","Maceió","Sim","UFAL","Graduação",2023
"46","stFemale","Feminino",13,"936fd080-9e6b-11eb-9b7e-0daf340a71ab",1618545834282,1618546931980,4.58257569495584,3.777777778,"4,1,4,3,4,4,5,4,5",4,1,4,3,4,4,5,4,5,"4, 2, 2, 3, 1, 1",4,2,2,3,1,1,14,3,"4,1,4,1,7,2,6,6,6,4,2,2,1,7,7,6,6",4,1,4,1,7,2,6,6,6,4,2,2,1,7,7,6,6,1.666666667,6.5,1.58,3.17,5.5,2.83,4.625,"4,5,5,4,5,4,5,5",4,5,5,4,5,4,5,5,"inBoost",25,"Branco","Heterossexual","Solteiro(a)","Marechal Deodoro","Sim","UFAL","Graduação",2023
"47","stFemale","Feminino",22,"0cae3c90-a81f-11eb-8cbb-599e427a3fce",1619613135745,1619613581292,7.14142842854285,2.444444444,"4,1,3,2,2,3,2,1,4",4,1,3,2,2,3,2,1,4,"4, 5, 2, 5, 5, 5",4,5,2,5,5,5,3,3.67,"1,1,1,1,3,1,4,4,4,4,1,2,1,4,4,4,4",1,1,1,1,3,1,4,4,4,4,1,2,1,4,4,4,4,1.333333333,4,2.67,1.33,4,2.67,4,"5,5,3,1,5,5,3,5",5,5,3,1,5,5,3,5,"inBoost",19,"Branco","Heterossexual","Solteiro(a)","Campo Grande","Sim","UFMS","Graduação",2024
"48","stFemale","Feminino",44,"63642710-b829-11eb-93e6-43229aa359ae",1621376622399,1621377222178,5.56776436283002,3.555555556,"3,2,4,4,3,3,4,4,5",3,2,4,4,3,3,4,4,5,"4, 5, 5, 4, 5, 4",4,5,5,4,5,4,4,4.33,"1,1,2,1,3,2,5,7,4,4,4,2,1,1,3,3,4",1,1,2,1,3,2,5,7,4,4,4,2,1,1,3,3,4,2.333333333,2.75,3.79,1.67,5,2.33,3.75,"3,4,4,2,5,4,3,5",3,4,4,2,5,4,3,5,"inBoost",33,"Pardo","Heterossexual","Solteiro(a)","Maceió","Sim","UFAL","Graduação",2021
"49","stFemale","Feminino",52,"cc9a1970-dba5-11eb-916d-ef9a5fc9a834",1625278319917,1625278970072,6.40312423743285,3.666666667,"4,4,4,3,2,4,2,5,5",4,4,4,3,2,4,2,5,5,"4, 5, 4, 3, 4, 4",4,5,4,3,4,4,5,3.67,"6,6,6,4,6,5,3,6,3,5,4,5,5,4,6,5,7",6,6,6,4,6,5,3,6,3,5,4,5,5,4,6,5,7,4.666666667,5.5,3.58,5.5,4.25,4.63,4,"5,3,5,4,4,4,4,3",5,3,5,4,4,4,4,3,"inBoost",21,"Prefiro não Responder","Bissexual","Solteiro(a)","Maceió","Sim","UFAL","Graduação",2022
"50","stFemale","Feminino",75,"ed40fb60-df62-11eb-bf23-972ef7bdc96c",1625689216572,1625689960325,8.42614977317636,3.555555556,"3,3,4,3,4,2,4,4,5",3,3,4,3,4,2,4,4,5,"3, 1, 3, 4, 4, 5",3,1,3,4,4,5,8,3.33,"2,1,3,1,5,3,6,6,5,6,4,3,1,7,7,7,6",2,1,3,1,5,3,6,6,5,6,4,3,1,7,7,7,6,2.666666667,6.75,1.96,2.5,5.75,2.38,4.625,"5,4,4,5,5,4,5,5",5,4,4,5,5,4,5,5,"inBoost",19,"Branco","Heterossexual","Solteiro(a)","Arapiraca","Sim","UFAL","Graduação",2024
"51","stFemale","Feminino",82,"3ee47f00-df72-11eb-bf23-972ef7bdc96c",1625695525960,1625696204660,4.58257569495584,3.444444444,"4,2,4,2,4,3,4,5,3",4,2,4,2,4,3,4,5,3,"3, 5, 3, 3, 5, 4",3,5,3,3,5,4,4,3,"5,3,3,1,5,5,3,4,4,3,2,2,2,4,4,3,4",5,3,3,1,5,5,3,4,4,3,2,2,2,4,4,3,4,2,3.75,3.13,3.67,3.5,4.08,3.625,"4,4,3,4,3,3,3,5",4,4,3,4,3,3,3,5,"inBoost",21,"Pardo","Heterossexual","Solteiro(a)","Maceió","Sim","UFAL","Graduação",2024
"52","stFemale","Feminino",94,"fdc45180-efb6-11eb-991d-7bf2f9a6c3b9",1627484632134,1627485310517,7.14142842854285,3.444444444,"3,2,4,4,4,3,3,5,3",3,2,4,4,4,3,3,5,3,"3, 3, 3, 3, 5, 3",3,3,3,3,5,3,7,3,"4,3,3,1,5,2,3,4,5,5,3,3,2,4,4,3,5",4,3,3,1,5,2,3,4,5,5,3,3,2,4,4,3,5,2.666666667,4,3.33,3,4.25,3.38,4,"5,5,4,3,5,3,3,4",5,5,4,3,5,3,3,4,"inBoost",21,"Branco","Heterossexual","Solteiro(a)","Maceió","Sim","UFAL","Graduação",2024
"53","stFemale","Feminino",100,"37869fe0-f6e7-11eb-991d-7bf2f9a6c3b9",1628275209826,1628275738638,8.42614977317636,3.555555556,"4,3,4,3,3,3,4,5,3",4,3,4,3,3,3,4,5,3,"3, 5, 4, 4, 4, 4",3,5,4,4,4,4,5,3.67,"2,3,5,1,4,1,7,5,4,7,1,1,1,4,4,4,4",2,3,5,1,4,1,7,5,4,7,1,1,1,4,4,4,4,1,4,2.5,2.67,5.75,2.46,3.5,"3,2,5,5,4,3,3,3",3,2,5,5,4,3,3,3,"inBoost",35,"Branco","Heterossexual","Casado(a)","Maceió","Sim","UFAL","Graduação",2023
"54","stFemale","Feminino",102,"670fa950-f6e7-11eb-991d-7bf2f9a6c3b9",1628275270435,1628275791276,7.81024967590665,3.222222222,"5,3,4,3,2,2,1,5,4",5,3,4,3,2,2,1,5,4,"1, 1, 4, 1, 3, 1",1,1,4,1,3,1,13,2,"5,6,6,5,5,6,2,3,4,2,6,6,4,1,2,1,5",5,6,6,5,5,6,2,3,4,2,6,6,4,1,2,1,5,5.333333333,2.25,5.54,5.5,2.75,5.38,2,"5,2,1,4,1,1,1,1",5,2,1,4,1,1,1,1,"inBoost",19,"Pardo","Heterossexual","Solteiro(a)","Maceió","Sim","UFAL","Graduação",2015
"55","stFemale","Feminino",103,"a59955e0-f6e7-11eb-991d-7bf2f9a6c3b9",1628275285186,1628275891680,6.40312423743285,3.333333333,"2,2,4,3,3,3,4,4,5",2,2,4,3,3,3,4,4,5,"4, 5, 4, 4, 4, 3",4,5,4,4,4,3,6,4,"1,1,2,1,6,1,7,5,7,7,2,2,1,6,6,6,6",1,1,2,1,6,1,7,5,7,7,2,2,1,6,6,6,6,1.666666667,6,1.83,2,6.5,1.75,4.375,"5,5,4,3,5,4,4,5",5,5,4,3,5,4,4,5,"inBoost",20,"Pardo","Homossexual","Solteiro(a)","Rio Largo","Sim","UFAL","Graduação",2022
"56","stFemale","Feminino",104,"f8b19d00-f6e7-11eb-991d-7bf2f9a6c3b9",1628275372963,1628276020185,9.53939201416946,3.333333333,"5,1,5,1,5,3,2,5,3",5,1,5,1,5,3,2,5,3,"4, 5, 1, 5, 5, 5",4,5,1,5,5,5,3,3.33,"2,2,3,1,4,1,4,4,4,4,1,1,1,5,5,5,5",2,2,3,1,4,1,4,4,4,4,1,1,1,5,5,5,5,1,5,2,2.17,4,3.08,3.125,"2,2,4,5,3,3,3,3",2,2,4,5,3,3,3,3,"inBoost",20,"Branco","Heterossexual","Solteiro(a)","Rio Largo","Sim","Ufal","Graduação",2023
"57","stFemale","Feminino",105,"175e8c90-f6e8-11eb-991d-7bf2f9a6c3b9",1628275231812,1628276109771,5.56776436283002,3.666666667,"4,3,4,4,4,3,3,3,5",4,3,4,4,4,3,3,3,5,"4, 5, 5, 5, 5, 5",4,5,5,5,5,5,3,4.67,"7,4,3,1,2,2,3,3,3,3,4,3,3,3,4,4,4",7,4,3,1,2,2,3,3,3,3,4,3,3,3,4,4,4,3.333333333,3.75,3.79,3.17,3,4.08,2.5,"3,3,3,3,3,1,1,3",3,3,3,3,3,1,1,3,"inBoost",22,"Branco","Heterossexual","Solteiro(a)","Maceió","Sim","Ufal","Graduação",2023
"58","stFemale","Feminino",106,"48089660-f6e8-11eb-991d-7bf2f9a6c3b9",1628275356422,1628276180800,6.40312423743285,2.888888889,"3,3,2,3,3,3,2,4,3",3,3,2,3,3,3,2,4,3,"3, 5, 4, 5, 5, 5",3,5,4,5,5,5,3,4,"5,1,5,1,5,5,2,5,1,3,1,1,1,6,5,6,3",5,1,5,1,5,5,2,5,1,3,1,1,1,6,5,6,3,1,5,2,3.67,2.75,4.46,4.375,"4,5,5,5,4,3,5,4",4,5,5,5,4,3,5,4,"inBoost",20,"Branco","Heterossexual","Solteiro(a)","Maceió","Sim","Ufal","Graduação",2023
"60","stFemale","Masculino",23,"48ed6aa0-a824-11eb-8cbb-599e427a3fce",1619614119186,1619615819166,7.81024967590665,3,"4,3,3,2,3,3,4,3,2",4,3,3,2,3,3,4,3,2,"3, 1, 2, 1, 3, 3",3,1,2,1,3,3,11,2,"1,1,1,1,5,1,2,4,4,6,2,2,1,3,3,3,6",1,1,1,1,5,1,2,4,4,6,2,2,1,3,3,3,6,1.666666667,3.75,2.96,1.67,4,2.83,3.375,"5,5,4,1,3,4,3,2",5,5,4,1,3,4,3,2,"inThreat",26,"Branco","Assexual","Solteiro(a)","Campo Grande","Sim","UFMS","Graduação",2023
"63","stFemale","Masculino",42,"65ae5870-b819-11eb-93e6-43229aa359ae",1621369944618,1621370358940,7.81024967590665,3,"4,3,3,5,3,1,1,5,2",4,3,3,5,3,1,1,5,2,"3, 5, 2, 1, 5, 4",3,5,2,1,5,4,4,2,"1,1,7,1,7,6,1,1,1,4,1,5,1,1,1,1,1",1,1,7,1,7,6,1,1,1,4,1,5,1,1,1,1,1,2.333333333,1,4.67,3.83,1.75,5.04,2.25,"5,1,2,5,1,1,2,1",5,1,2,5,1,1,2,1,"inThreat",20,"Pardo","Heterossexual","Solteiro(a)","Feira Grande - AL","Sim","UFAL","Graduação",2026
"65","stFemale","Masculino",62,"fe83e2d0-df61-11eb-bf23-972ef7bdc96c",1625689168344,1625689615181,6.40312423743285,3.333333333,"3,1,4,3,4,3,3,4,5",3,1,4,3,4,3,3,4,5,"3, 5, 3, 2, 5, 4",3,5,3,2,5,4,4,2.67,"5,4,4,2,5,5,2,4,2,2,3,3,2,7,6,6,5",5,4,4,2,5,5,2,4,2,2,3,3,2,7,6,6,5,2.666666667,6,2.33,4.17,2.5,4.83,4.5,"4,4,5,5,5,4,5,4",4,4,5,5,5,4,5,4,"inThreat",19,"Negro","Heterossexual","Solteiro(a)","Rio Largo","Sim","UFAL","Graduação",2024
"67","stFemale","Masculino",68,"7cc13d00-df62-11eb-bf23-972ef7bdc96c",1625689253132,1625689884063,3.3166247903554,4.111111111,"4,3,5,1,5,4,5,5,5",4,3,5,1,5,4,5,5,5,"5, 3, 5, 3, 5, 5",5,3,5,3,5,5,5,4.33,"1,1,2,1,1,1,7,7,4,7,1,1,1,4,4,5,7",1,1,2,1,1,1,7,7,4,7,1,1,1,4,4,5,7,1,5,2,1.17,6.25,1.46,4.25,"3,5,5,3,5,5,3,5",3,5,5,3,5,5,3,5,"inThreat",18,"Pardo","Homossexual","Solteiro(a)","Maceió","Sim","UFAL","Graduação",2024
"70","stFemale","Masculino",79,"32195750-df63-11eb-bf23-972ef7bdc96c",1625689170370,1625690146146,4.58257569495584,3.111111111,"3,2,3,4,3,3,2,4,4",3,2,3,4,3,3,2,4,4,"2, 5, 2, 3, 5, 5",2,5,2,3,5,5,3,2.33,"2,2,5,1,5,5,2,4,5,4,2,2,2,4,4,4,4",2,2,5,1,5,5,2,4,5,4,2,2,2,4,4,4,4,2,4,3,3.33,3.75,3.79,3.875,"4,3,4,5,5,3,3,4",4,3,4,5,5,3,3,4,"inThreat",19,"Branco","Heterossexual","Solteiro(a)","Maceió","Sim","UFAL","Graduação",2024
"71","stFemale","Masculino",80,"412915a0-df63-11eb-bf23-972ef7bdc96c",1625689223976,1625690027876,3.3166247903554,3.111111111,"3,4,2,3,2,4,3,3,4",3,4,2,3,2,4,3,3,4,"4, 4, 4, 3, 5, 5",4,4,4,3,5,5,4,3.67,"2,3,1,1,2,5,6,7,5,6,1,1,1,6,7,7,6",2,3,1,1,2,5,6,7,5,6,1,1,1,6,7,7,6,1,6.5,1.25,2.33,6,2.17,4.25,"4,4,5,2,4,5,5,5",4,4,5,2,4,5,5,5,"inThreat",19,"Branco","Heterossexual","Solteiro(a)","Maceió","Sim","UFAL","Graduação",2024
"72","stFemale","Masculino",86,"e6b9afe0-efb5-11eb-991d-7bf2f9a6c3b9",1627484618181,1627484929765,7.14142842854285,3.777777778,"4,3,3,5,3,4,3,4,5",4,3,3,5,3,4,3,4,5,"3, 4, 4, 3, 4, 3",3,4,4,3,4,3,7,3.33,"1,1,1,1,2,2,6,6,4,,1,1,1,4,4,4,5",1,1,1,1,2,2,6,6,4,NA,1,1,1,4,4,4,5,1,4.25,2.38,1.33,5.33,2,3.75,"4,3,5,3,4,4,3,4",4,3,5,3,4,4,3,4,"inThreat",20,"Pardo","Heterossexual","Solteiro(a)","Arapiraca","Sim","UFAL","Graduação",2024
"73","stFemale","Masculino",95,"084deb70-efb7-11eb-991d-7bf2f9a6c3b9",1627484631668,1627485351806,7.14142842854285,3.111111111,"3,2,4,3,4,4,4,1,3",3,2,4,3,4,4,4,1,3,"2, 5, 4, 1, 4, 4",2,5,4,1,4,4,5,2.33,"1,1,1,1,1,1,6,6,6,6,3,3,1,4,4,4,6",1,1,1,1,1,1,6,6,6,6,3,3,1,4,4,4,6,2.333333333,4.5,2.92,1,6,1.5,3.625,"4,4,4,1,5,4,3,4",4,4,4,1,5,4,3,4,"inThreat",30,"Pardo","Bissexual","Solteiro(a)","Maceió","Sim","UFAL","Graduação",2024
"74","stMale","Feminino",5,"4b869a80-9d4c-11eb-9b7e-0daf340a71ab",1618423216595,1618423569437,7.81024967590665,3.333333333,"4,1,4,3,4,4,4,3,3",4,1,4,3,4,4,4,3,3,"4, 5, 3, 4, 2, 2",4,5,3,4,2,2,9,3.67,"1,1,1,1,2,2,6,4,6,3,5,1,1,4,4,3,6",1,1,1,1,2,2,6,4,6,3,5,1,1,4,4,3,6,2.333333333,4.25,3.04,1.33,4.75,2.29,3.625,"4,5,3,2,4,4,3,4",4,5,3,2,4,4,3,4,"inThreat",21,"Pardo","Heterossexual","Solteiro(a)","Maceió","Sim","Universidade Federal de Alagoas","Graduação",2022
"75","stMale","Feminino",9,"906a5a80-9e30-11eb-9b7e-0daf340a71ab",1618521419844,1618521649027,5.56776436283002,5,"5,5,5,5,5,5,5,5,5",5,5,5,5,5,5,5,5,5,"4, 2, 2, 4, 3, 1",4,2,2,4,3,1,12,3.33,"6,6,6,1,6,5,1,7,1,1,1,5,1,5,5,5,2",6,6,6,1,6,5,1,7,1,1,1,5,1,5,5,5,2,2.333333333,4.25,3.04,5,2.5,5.25,5,"5,5,5,5,5,5,5,5",5,5,5,5,5,5,5,5,"inThreat",18,"Branco","Heterossexual","Solteiro(a)","Maceio","Sim","UFAL","Graduação",2026
"76","stMale","Feminino",14,"08861510-9ebb-11eb-9b7e-0daf340a71ab",1618580786711,1618581023344,10.216062264584,3.777777778,"4,3,4,5,4,3,3,4,4",4,3,4,5,4,3,3,4,4,"4, 5, 4, 4, 5, 5",4,5,4,4,5,5,3,4,"4,2,4,1,3,1,5,6,3,3,3,3,1,4,4,4,4",4,2,4,1,3,1,5,6,3,3,3,3,1,4,4,4,4,2.333333333,4,3.17,2.5,4.25,3.13,3.25,"4,3,3,1,3,4,4,4",4,3,3,1,3,4,4,4,"inThreat",24,"Negro","Heterossexual","Solteiro(a)","","Sim","","Outros",2022
"77","stMale","Feminino",18,"9186bb20-a47f-11eb-8cbb-599e427a3fce",1619213901074,1619215154099,4.13949287834569,2.666666667,"3,3,2,2,3,2,3,3,3",3,3,2,2,3,2,3,3,3,"4, 3, 4, 5, 5, 5",4,3,4,5,5,5,5,4.33,"3,3,3,2,4,4,2,2,2,2,2,3,3,3,3,2,2",3,3,3,2,4,4,2,2,2,2,2,3,3,3,3,2,2,2.666666667,2.5,4.08,3.17,2,4.58,3.5,"4,5,4,2,3,3,2,5",4,5,4,2,3,3,2,5,"inThreat",53,"Branco","Heterossexual","Divorciado(a)","São Paulo","Não","","Mestrado",NA
"78","stMale","Feminino",19,"a5bebe50-a48c-11eb-8cbb-599e427a3fce",1619220170772,1619220799188,7.81024967590665,3.222222222,"3,3,3,4,3,4,3,3,3",3,3,3,4,3,4,3,3,3,"4, 3, 4, 4, 3, 2",4,3,4,4,3,2,10,4,"5,4,4,3,4,3,5,6,4,4,3,3,3,6,6,6,6",5,4,4,3,4,3,5,6,4,4,3,3,3,6,6,6,6,3,6,2.5,3.83,4.75,3.54,4.75,"5,5,5,4,4,5,5,5",5,5,5,4,4,5,5,5,"inThreat",52,"Branco","Heterossexual","Casado(a)","Brasilia","Não","","Graduação",NA
"79","stMale","Feminino",30,"3d203cb0-af41-11eb-b944-15c8c1c6ce71",1620397310059,1620397854960,4.58257569495584,3.444444444,"3,1,5,3,5,5,1,5,3",3,1,5,3,5,5,1,5,3,"5, 5, 5, 5, 5, 4",5,5,5,5,5,4,4,5,"4,5,6,1,3,6,2,7,2,4,3,3,1,7,7,7,5",4,5,6,1,3,6,2,7,2,4,3,3,1,7,7,7,5,2.333333333,6.5,1.92,4.17,3.75,4.21,4.75,"4,5,5,5,5,5,4,5",4,5,5,5,5,5,4,5,"inThreat",25,"Negro","Homossexual","Solteiro(a)","Maceió","Não","Universidade Federal de Alagoas","Graduação",NA
"80","stMale","Feminino",43,"5f6ad630-b825-11eb-93e6-43229aa359ae",1621375094890,1621375508474,7.81024967590665,3,"3,1,5,3,2,2,1,5,5",3,1,5,3,2,2,1,5,5,"3, 1, 5, 3, 5, 5",3,1,5,3,5,5,7,3.67,"7,7,7,3,4,7,1,7,1,1,3,3,3,6,6,6,1",7,7,7,3,4,7,1,7,1,1,3,3,3,6,6,6,1,3,4.75,3.13,5.83,2.5,5.67,3.5,"5,1,5,1,5,4,3,4",5,1,5,1,5,4,3,4,"inThreat",23,"Pardo","Heterossexual","Solteiro(a)","Maribondo","Sim","Ufal","Graduação",2023
"81","stMale","Feminino",50,"12bc0350-c463-11eb-9261-891d55fc2af9",1622720539000,1622721230505,9.53939201416946,4.111111111,"4,2,5,4,5,4,4,5,4",4,2,5,4,5,4,4,5,4,"4, 4, 3, 4, 5, 5",4,4,3,4,5,5,4,3.67,"1,1,1,1,2,1,7,7,7,7,4,4,1,5,4,4,4",1,1,1,1,2,1,7,7,7,7,4,4,1,5,4,4,4,3,4.25,3.38,1.17,7,1.08,3.625,"3,3,4,4,4,4,3,4",3,3,4,4,4,4,3,4,"inThreat",56,"Pardo","Heterossexual","Solteiro(a)","Maceió","Sim","UFAL","Outros",NA
"82","stMale","Feminino",51,"c5628d20-c7cf-11eb-9261-891d55fc2af9",1623095914841,1623097598250,5.56776436283002,3.666666667,"4,3,5,4,4,3,3,2,5",4,3,5,4,4,3,3,2,5,"3, 5, 4, 4, 5, 4",3,5,4,4,5,4,4,3.67,"5,1,1,1,6,1,6,6,7,6,2,2,1,3,3,2,3",5,1,1,1,6,1,6,6,7,6,2,2,1,3,3,2,3,1.666666667,2.75,3.46,2.5,6.25,2.13,3.75,"4,3,3,5,4,3,3,5",4,3,3,5,4,3,3,5,"inThreat",24,"Pardo","Homossexual","Solteiro(a)","Jaru","Sim","UPAP","Graduação",10
"83","stMale","Feminino",88,"2d313ce0-efb6-11eb-991d-7bf2f9a6c3b9",1627484586441,1627485001456,7.14142842854285,3.666666667,"4,4,4,4,4,4,4,1,4",4,4,4,4,4,4,4,1,4,"4, 2, 5, 5, 2, 2",4,2,5,5,2,2,12,4.67,"3,2,2,2,6,2,6,2,6,6,2,2,2,4,4,4,4",3,2,2,2,6,2,6,2,6,6,2,2,2,4,4,4,4,2,4,3,2.83,5,2.92,3.375,"3,5,4,1,3,3,4,4",3,5,4,1,3,3,4,4,"inThreat",24,"Branco","Bissexual","Solteiro(a)","Maceió","Sim","UFAL","Graduação",2023
"84","stMale","Feminino",89,"56024dd0-efb6-11eb-991d-7bf2f9a6c3b9",1627484536763,1627485096105,6.40312423743285,4,"4,4,5,5,4,3,2,5,4",4,4,5,5,4,3,2,5,4,"5, 4, 5, 5, 5, 4",5,4,5,5,5,4,5,5,"1,1,2,1,2,1,7,7,7,7,1,1,,6,5,5,6",1,1,2,1,2,1,7,7,7,7,1,1,NA,6,5,5,6,1,5.5,1.75,1.33,7,1.17,4.5,"5,5,5,2,5,5,4,5",5,5,5,2,5,5,4,5,"inThreat",23,"Pardo","Heterossexual","Casado(a)","Maceio","Sim","Ufal","Graduação",0
"85","stMale","Feminino",90,"86f372c0-efb6-11eb-991d-7bf2f9a6c3b9",1627484572328,1627485050341,9.53939201416946,2.888888889,"3,1,3,4,3,3,2,4,3",3,1,3,4,3,3,2,4,3,"3, 5, 1, 1, 5, 3",3,5,1,1,5,3,5,1.67,"4,2,5,1,7,2,3,4,1,1,4,2,1,,1,1,1",4,2,5,1,7,2,3,4,1,1,4,2,1,NA,1,1,1,2.333333333,1,4.67,3.5,2.25,4.63,3.125,"3,5,2,3,5,2,1,4",3,5,2,3,5,2,1,4,"inThreat",21,"Pardo","Bissexual","Solteiro(a)","Maceió","Sim","UFAL","Graduação",2023
"86","stMale","Feminino",92,"d7092840-efb6-11eb-991d-7bf2f9a6c3b9",1627484824190,1627485311088,7.14142842854285,3.222222222,"4,4,2,3,2,2,5,5,2",4,4,2,3,2,2,5,5,2,"2, 3, 3, 2, 1, 1",2,3,3,2,1,1,13,2.33,"7,6,7,2,7,4,2,7,2,2,6,6,4,2,3,2,1",7,6,7,2,7,4,2,7,2,2,6,6,4,2,3,2,1,5.333333333,2,5.67,5.5,3.25,5.13,2.5,"2,3,3,5,1,2,1,3",2,3,3,5,1,2,1,3,"inThreat",19,"Negro","Bissexual","Solteiro(a)","Alagoas","Sim","ufal","Graduação",2023
"87","stMale","Feminino",96,"17469f50-efb7-11eb-991d-7bf2f9a6c3b9",1627484632557,1627485400814,7.81024967590665,2.666666667,"3,2,3,3,3,2,1,4,3",3,2,3,3,3,2,1,4,3,"3, 5, 2, 2, 5, 5",3,5,2,2,5,5,3,2.33,"3,2,3,1,5,2,4,4,5,3,2,2,1,3,3,2,4",3,2,3,1,5,2,4,4,5,3,2,2,1,3,3,2,4,1.666666667,3,3.33,2.67,4,3.33,3,"4,3,3,2,4,3,2,3",4,3,3,2,4,3,2,3,"inThreat",20,"Branco","Heterossexual","Solteiro(a)","","Sim","UFAL","Graduação",NA
"88","stMale","Masculino",2,"e6bed630-9d46-11eb-9b7e-0daf340a71ab",1618418879949,1618420998081,4.58257569495584,3.444444444,"4,3,4,2,4,2,4,4,4",4,3,4,2,4,2,4,4,4,"4, 5, 3, 4, 5, 5",4,5,3,4,5,5,3,3.67,"1,1,3,1,3,3,3,7,2,5,1,3,1,7,7,7,5",1,1,3,1,3,3,3,7,2,5,1,3,1,7,7,7,5,1.666666667,6.5,1.58,2,4.25,2.88,4,"5,1,5,1,5,5,5,5",5,1,5,1,5,5,5,5,"inBoost",23,"Branco","Heterossexual","Solteiro(a)","Maceió","Sim","Ufal","Graduação",2023
"89","stMale","Masculino",3,"d23aa670-9d47-11eb-9b7e-0daf340a71ab",1618420882885,1618421540768,6.40312423743285,4.222222222,"5,5,4,5,4,4,5,1,5",5,5,4,5,4,4,5,1,5,"3, 3, 3, 3, 4, 2",3,3,3,3,4,2,9,3,"2,2,2,1,1,2,6,6,6,7,1,1,1,7,6,6,7",2,2,2,1,1,2,6,6,6,7,1,1,1,7,6,6,7,1,6.5,1.25,1.67,6.25,1.71,4.25,"5,5,5,1,5,4,5,4",5,5,5,1,5,4,5,4,"inBoost",25,"Pardo","Heterossexual","Solteiro(a)","MACEIÓ","Sim","UFAL","Graduação",2023
"90","stMale","Masculino",12,"09bbd000-9e39-11eb-9b7e-0daf340a71ab",1618524679567,1618525250184,3.3166247903554,4.333333333,"4,5,4,4,5,4,5,5,3",4,5,4,4,5,4,5,5,3,"5, 5, 4, 5, 4, 4",5,5,4,5,4,4,5,4.67,"5,1,2,1,4,1,7,7,7,7,1,1,1,6,6,7,7",5,1,2,1,4,1,7,7,7,7,1,1,1,6,6,7,7,1,6.5,1.25,2.33,7,1.67,4.875,"5,4,5,5,5,5,5,5",5,4,5,5,5,5,5,5,"inBoost",21,"Branco","Heterossexual","Solteiro(a)","São Paulo","Sim","UFAL","Graduação",2022
"91","stMale","Masculino",16,"1160f4b0-a439-11eb-8cbb-599e427a3fce",1619184152491,1619184697698,9.53939201416946,4.777777778,"5,5,4,5,4,5,5,5,5",5,5,4,5,4,5,5,5,5,"3, 5, 3, 3, 5, 3",3,5,3,3,5,3,5,3,"6,6,7,5,7,7,3,6,5,2,6,6,6,2,4,2,2",6,6,7,5,7,7,3,6,5,2,6,6,6,2,4,2,2,6,2.5,5.75,6.33,4,5.17,3,"4,4,2,5,2,1,2,4",4,4,2,5,2,1,2,4,"inBoost",47,"Pardo","Heterossexual","Casado(a)","MANAUS","Sim","IBAC","Outros",2022
"92","stMale","Masculino",24,"b5e0a910-a833-11eb-8cbb-599e427a3fce",1619622138242,1619622726081,5.56776436283002,3.444444444,"4,2,4,3,3,3,3,4,5",4,2,4,3,3,3,3,4,5,"4, 4, 3, 4, 5, 5",4,4,3,4,5,5,4,3.67,"2,2,4,1,2,5,2,5,2,6,2,2,1,6,6,6,4",2,2,4,1,2,5,2,5,2,6,2,2,1,6,6,6,4,1.666666667,5.5,2.08,2.67,3.75,3.46,3.875,"3,4,3,4,5,3,5,4",3,4,3,4,5,3,5,4,"inBoost",20,"Branco","Heterossexual","Solteiro(a)","Campo Grande","Sim","Universidade Federal Do Mato Grosso Do Sul","Graduação",2024
"93","stMale","Masculino",29,"eb0ea380-aeb9-11eb-8cbb-599e427a3fce",1620339251971,1620339719942,10.0498756211209,3.555555556,"3,1,5,5,4,4,3,5,2",3,1,5,5,4,4,3,5,2,"3, 2, 4, 4, 1, 1",3,2,4,4,1,1,14,3.67,"6,4,7,1,3,1,7,5,7,7,1,1,1,5,5,5,5",6,4,7,1,3,1,7,5,7,7,1,1,1,5,5,5,5,1,5,2,3.67,6.5,2.58,4.875,"5,5,5,5,4,5,5,5",5,5,5,5,4,5,5,5,"inBoost",49,"Branco","Heterossexual","Casado(a)","Jaboatão dos Guararapes","Sim","IFPE","Doutorado",2026
"94","stMale","Masculino",35,"d79c21e0-b1db-11eb-b944-15c8c1c6ce71",1620683172964,1620684245218,5.56776436283002,2.777777778,"4,1,3,2,4,3,4,2,2",4,1,3,2,4,3,4,2,2,"3, 4, 3, 3, 5, 4",3,4,3,3,5,4,5,3,"1,1,4,2,4,2,5,5,6,6,5,5,2,2,2,2,7",1,1,4,2,4,2,5,5,6,6,5,5,2,2,2,2,7,4,3.25,4.38,2.33,5.5,2.42,3.875,"5,4,5,2,2,5,3,5",5,4,5,2,2,5,3,5,"inBoost",21,"Pardo","Heterossexual","Solteiro(a)","Sobradinho","Sim","UnB","Graduação",2023
"95","stMale","Masculino",39,"77a7a000-b264-11eb-b944-15c8c1c6ce71",1620742554261,1620742929559,5.56776436283002,3.111111111,"4,3,4,3,2,2,2,4,4",4,3,4,3,2,2,2,4,4,"3, 2, 2, 2, 2, 2",3,2,2,2,2,2,12,2.33,"2,2,3,1,3,3,5,7,4,6,1,2,1,6,4,3,5",2,2,3,1,3,3,5,7,4,6,1,2,1,6,4,3,5,1.333333333,4.5,2.42,2.33,5.5,2.42,2.625,"4,1,4,2,1,3,3,3",4,1,4,2,1,3,3,3,"inBoost",22,"Pardo","Heterossexual","Solteiro(a)","Taguatinga","Sim","Universidade de Brasilia","Graduação",2022
"96","stMale","Masculino",41,"08506260-b812-11eb-93e6-43229aa359ae",1621365406713,1621367195820,9.53939201416946,3,"4,5,2,1,2,1,4,5,3",4,5,2,1,2,1,4,5,3,"3, 1, 1, 4, 1, 1",3,1,1,4,1,1,15,2.67,"3,3,3,6,7,4,4,2,6,6,4,3,5,4,3,5,5",3,3,3,6,7,4,4,2,6,6,4,3,5,4,3,5,5,4,4.25,3.88,4.33,4.5,3.92,2.875,"2,4,3,4,3,2,3,2",2,4,3,4,3,2,3,2,"inBoost",26,"Branco","Heterossexual","Solteiro(a)","Ceilândia","Sim","UnB","",NA
"97","stMale","Masculino",45,"8fe50750-b82e-11eb-93e6-43229aa359ae",1621378457469,1621379414540,5.56776436283002,3.555555556,"4,3,4,4,4,3,4,4,2",4,3,4,4,4,3,4,4,2,"3, 4, 4, 4, 5, 5",3,4,4,4,5,5,4,3.67,"3,2,3,1,3,2,6,6,5,6,2,2,1,5,6,6,6",3,2,3,1,3,2,6,6,5,6,2,2,1,5,6,6,6,1.666666667,5.75,1.96,2.33,5.75,2.29,4,"4,3,4,4,5,4,4,4",4,3,4,4,5,4,4,4,"inBoost",24,"Branco","Heterossexual","Solteiro(a)","Maceió","Sim","UFAL","Graduação",2026
"98","stMale","Masculino",47,"a17bb480-bf06-11eb-93e6-43229aa359ae",1622128933140,1622131697258,3.3166247903554,3,"3,3,3,3,3,3,3,3,3",3,3,3,3,3,3,3,3,3,"3, 3, 3, 3, 3, 3",3,3,3,3,3,3,9,3,"2,2,2,1,3,1,6,6,6,6,2,2,2,6,5,6,6",2,2,2,1,3,1,6,6,6,6,2,2,2,6,5,6,6,2,5.75,2.13,1.83,6,1.92,4.375,"5,4,5,4,5,4,4,4",5,4,5,4,5,4,4,4,"inBoost",20,"Pardo","Heterossexual","Solteiro(a)","","Sim","UnB","Graduação",NA
"99","stMale","Masculino",49,"0ed06520-c18d-11eb-93e6-43229aa359ae",1622409002885,1622409620393,4.58257569495584,3,"3,2,3,3,2,2,4,4,4",3,2,3,3,2,2,4,4,4,"4, 4, 3, 4, 4, 3",4,4,3,4,4,3,7,3.67,"4,5,5,2,5,3,5,5,5,4,3,2,2,5,5,4,4",4,5,5,2,5,3,5,5,5,4,3,2,2,5,5,4,4,2.333333333,4.5,2.92,4,4.75,3.63,4.5,"5,5,4,4,5,5,4,4",5,5,4,4,5,5,4,4,"inBoost",39,"Branco","Heterossexual","União estável","Joinville","Sim","Udesc - Joinville","Graduação",2006
"100","stMale","Masculino",56,"8b51aea0-df61-11eb-bf23-972ef7bdc96c",1625689115410,1625689435899,10.0498756211209,3.111111111,"3,4,4,3,3,3,4,1,3",3,4,4,3,3,3,4,1,3,"4, 5, 3, 3, 5, 4",4,5,3,3,5,4,4,3.33,"3,1,1,1,4,2,6,6,7,5,2,3,1,4,5,4,7",3,1,1,1,4,2,6,6,7,5,2,3,1,4,5,4,7,2,5,2.5,2,6,2,3.75,"4,5,4,1,4,4,3,5",4,5,4,1,4,4,3,5,"inBoost",20,"Pardo","Heterossexual","Solteiro(a)","Maceió","Sim","UFAL","Graduação",2024
"101","stMale","Masculino",60,"f343a310-df61-11eb-bf23-972ef7bdc96c",1625689142358,1625689645454,6.40312423743285,3.222222222,"5,2,3,2,4,2,1,5,5",5,2,3,2,4,2,1,5,5,"3, 1, 4, 4, 5, 3",3,1,4,4,5,3,9,3.67,"2,4,2,1,2,4,6,6,5,6,1,1,1,6,4,4,4",2,4,2,1,2,4,6,6,5,6,1,1,1,6,4,4,4,1,4.5,2.25,2.5,5.75,2.38,3.75,"5,1,5,1,5,5,3,5",5,1,5,1,5,5,3,5,"inBoost",21,"Pardo","Heterossexual","Solteiro(a)","MACEIÓ","Sim","ufal","Graduação",2025
"102","stMale","Masculino",61,"fe2e21b0-df61-11eb-bf23-972ef7bdc96c",1625689189923,1625689655192,6.40312423743285,3.333333333,"3,3,4,3,3,4,4,3,3",3,3,4,3,3,4,4,3,3,"3, 3, 3, 3, 3, 3",3,3,3,3,3,3,9,3,"1,1,1,1,2,1,7,,5,7,1,1,1,4,4,4,4",1,1,1,1,2,1,7,NA,5,7,1,1,1,4,4,4,4,1,4,2.5,1.17,6.33,1.42,3.625,"5,5,3,1,4,5,3,3",5,5,3,1,4,5,3,3,"inBoost",23,"Branco","Heterossexual","Solteiro(a)","União Dos Palmares","Sim","Ufal","Graduação",NA
"103","stMale","Masculino",65,"4282ceb0-df62-11eb-bf23-972ef7bdc96c",1625689164892,1625689744465,7.14142842854285,3.777777778,"4,3,4,4,4,5,2,4,4",4,3,4,4,4,5,2,4,4,"4, 5, 3, 4, 5, 5",4,5,3,4,5,5,3,3.67,"3,3,4,2,5,1,6,6,6,4,2,2,2,4,2,3,4",3,3,4,2,5,1,6,6,6,4,2,2,2,4,2,3,4,2,3.25,3.38,3,5.5,2.75,3.25,"5,4,4,1,3,3,3,3",5,4,4,1,3,3,3,3,"inBoost",19,"Branco","Heterossexual","Solteiro(a)","Maceió","Sim","UFAL","Outros",2024
"104","stMale","Masculino",74,"bb4962f0-df62-11eb-bf23-972ef7bdc96c",1625689144081,1625689959093,3.3166247903554,4.444444444,"4,4,5,5,3,5,5,4,5",4,4,5,5,3,5,5,4,5,"5, 2, 4, 5, 4, 1",5,2,4,5,4,1,11,4.67,"4,1,1,1,1,2,1,6,2,2,1,1,1,6,6,5,5",4,1,1,1,1,2,1,6,2,2,1,1,1,6,6,5,5,1,5.5,1.75,1.67,2.75,3.46,4.5,"5,4,5,2,5,5,5,5",5,4,5,2,5,5,5,5,"inBoost",20,"Pardo","Heterossexual","Solteiro(a)","MACEIÓ","Sim","ufal","Graduação",2024
"105","stMale","Masculino",76,"20b9dca0-df63-11eb-bf23-972ef7bdc96c",1625689301560,1625690098312,8.42614977317636,2.444444444,"2,1,2,3,1,3,4,4,2",2,1,2,3,1,3,4,4,2,"4, 4, 4, 4, 5, 4",4,4,4,4,5,4,5,4,"7,2,6,1,3,3,6,5,3,1,2,2,1,4,6,4,6",7,2,6,1,3,3,6,5,3,1,2,2,1,4,6,4,6,1.666666667,5,2.33,3.67,3.75,3.96,3.875,"5,4,2,5,4,4,3,4",5,4,2,5,4,4,3,4,"inBoost",26,"Negro","Heterossexual","Solteiro(a)","Rolim de Moura","Sim","UFAL","Graduação",3
"106","stMale","Masculino",78,"25210750-df63-11eb-bf23-972ef7bdc96c",1625689608465,1625690090821,6.40312423743285,4,"5,2,4,5,4,4,4,4,4",5,2,4,5,4,4,4,4,4,"4, 4, 3, 4, 5, 4",4,4,3,4,5,4,5,3.67,"5,4,4,2,3,2,6,6,5,4,2,2,2,5,5,4,6",5,4,4,2,3,2,6,6,5,4,2,2,2,5,5,4,6,2,5,2.5,3.33,5.25,3.04,4.375,"5,5,4,4,5,5,3,4",5,5,4,4,5,5,3,4,"inBoost",21,"Branco","Heterossexual","Solteiro(a)","Maceió","Sim","Universidade Federal de Alagoas","Graduação",2024
"107","stMale","Masculino",83,"8047d7e0-e656-11eb-aeff-859c71bd906c",1626454064062,1626454422716,3.3166247903554,3.333333333,"4,4,5,3,3,2,2,4,3",4,4,5,3,3,2,2,4,3,"2, 3, 3, 3, 5, 2",2,3,3,3,5,2,8,2.67,"4,5,5,1,1,4,4,6,6,3,1,1,1,6,5,5,5",4,5,5,1,1,4,4,6,6,3,1,1,1,6,5,5,5,1,5.25,1.88,3.33,4.75,3.29,4.625,"5,5,4,3,5,5,5,5",5,5,4,3,5,5,5,5,"inBoost",22,"Pardo","Heterossexual","Solteiro(a)","Limoeiro de Anadia","Sim","UFAL","Graduação",2023
