responseId,startTime,endTime,testType,activityPoints,dfs,dfsRaw,dfsRaw01,dfsRaw02,dfsRaw03,dfsRaw04,dfsRaw05,dfsRaw06,dfsRaw07,dfsRaw08,dfsRaw09,dejectionRawPre2,FR01,FR04,FR03,FR10,FR02,FR06,prevention.pre,promotion.pre,dejectionRawPost,tense,nervous,anxious,depressed,uncertain,agitated,calm,self_conscious,quiet,unconcerned,disappointed ,frustrated,sad,contented,enthusiastic,happy,balanced,dejection,cheerfulness,promotion.pos,agitation,quiescence,prevention.pos,fss,flow,flow01,flow02,flow03,flow04,flow05,flow06,flow07,flow08,Condition,gender,age,ethnicity,sexualOrientation,civilState,city,universityEducation,institucion,educationLevel,conclusion
208ec0b0-9d46-11eb-9b7e-0daf340a71ab,1618420145528,1618420954258,stFemale,150,4.222222222,"2,4,4,5,5,3,5,5,5",2,4,4,5,5,3,5,5,5,"4, 3, 5, 4, 2, 2",4,3,5,4,2,2,3.67,4.33,"7,6,7,5,6,1,7,4,6,6,5,5,4,6,5,5,4",7,6,7,5,6,1,7,4,6,6,5,5,4,6,5,5,4,4.666666667,5,3.83,5.33,5.75,3.79,3.875,"4,3,4,3,4,4,5,4",4,3,4,3,4,4,5,4,inThreat,Masculino,25,Pardo,Heterossexual,Solteiro(a),MACEIÓ,Sim,UFAL,Graduação,8
e6bed630-9d46-11eb-9b7e-0daf340a71ab,1618418879949,1618420998081,stMale,180,3.444444444,"4,3,4,2,4,2,4,4,4",4,3,4,2,4,2,4,4,4,"4, 5, 3, 4, 5, 5",4,5,3,4,5,5,1.00,3.67,"1,1,3,1,3,3,3,7,2,5,1,3,1,7,7,7,5",1,1,3,1,3,3,3,7,2,5,1,3,1,7,7,7,5,1.666666667,6.5,1.58,2.00,4.25,2.88,4,"5,1,5,1,5,5,5,5",5,1,5,1,5,5,5,5,inBoost,Masculino,23,Branco,Heterossexual,Solteiro(a),Maceió,Sim,Ufal,Graduação,2023
d23aa670-9d47-11eb-9b7e-0daf340a71ab,1618420882885,1618421540768,stMale,160,4.222222222,"5,5,4,5,4,4,5,1,5",5,5,4,5,4,4,5,1,5,"3, 3, 3, 3, 4, 2",3,3,3,3,4,2,3.00,3.00,"2,2,2,1,1,2,6,6,6,7,1,1,1,7,6,6,7",2,2,2,1,1,2,6,6,6,7,1,1,1,7,6,6,7,1,6.5,1.25,1.67,6.25,1.71,4.25,"5,5,5,1,5,4,5,4",5,5,5,1,5,4,5,4,inBoost,Masculino,25,Pardo,Heterossexual,Solteiro(a),MACEIÓ,Sim,UFAL,Graduação,2023
358e5340-9d4b-11eb-9b7e-0daf340a71ab,1618422301740,1618422916334,stFemale,50,4,"3,3,4,5,5,3,5,5,3",3,3,4,5,5,3,5,5,3,"5, 1, 5, 1, 1, 1",5,1,5,1,1,1,5.00,3.67,"7,7,7,4,7,7,1,1,1,1,7,7,7,1,4,1,4",7,7,7,4,7,7,1,1,1,1,7,7,7,1,4,1,4,7,2.5,6.25,6.50,1.00,6.75,4,"5,5,5,5,5,3,1,3",5,5,5,5,5,3,1,3,inBoost,Feminino,48,Negro,Homossexual,Solteiro(a),,Sim,Ufal,Graduação,2025
4b869a80-9d4c-11eb-9b7e-0daf340a71ab,1618423216595,1618423569437,stMale,140,3.333333333,"4,1,4,3,4,4,4,3,3",4,1,4,3,4,4,4,3,3,"4, 5, 3, 4, 2, 2",4,5,3,4,2,2,3.00,3.67,"1,1,1,1,2,2,6,4,6,3,5,1,1,4,4,3,6",1,1,1,1,2,2,6,4,6,3,5,1,1,4,4,3,6,2.333333333,4.25,3.04,1.33,4.75,2.29,3.625,"4,5,3,2,4,4,3,4",4,5,3,2,4,4,3,4,inThreat,Feminino,21,Pardo,Heterossexual,Solteiro(a),Maceió,Sim,Universidade Federal de Alagoas,Graduação,2022
18379910-9df4-11eb-9b7e-0daf340a71ab,1618494713997,1618495449457,default,160,3,"3,3,4,2,2,3,2,4,4",3,3,4,2,2,3,2,4,4,"4, 5, 3, 3, 4, 2",4,5,3,3,4,2,2.33,3.33,"4,2,2,2,4,1,5,5,5,2,1,1,1,5,2,4,5",4,2,2,2,4,1,5,5,5,2,1,1,1,5,2,4,5,1,4,2.50,2.50,4.25,3.13,3.5,"4,4,2,2,4,5,2,5",4,4,2,2,4,5,2,5,control,Masculino,23,Branco,Heterossexual,Solteiro(a),Maceió,Sim,UFAL,Graduação,2023
4b9fd020-9e02-11eb-9b7e-0daf340a71ab,1618501325522,1618501732613,default,140,4.777777778,"5,4,5,5,4,5,5,5,5",5,4,5,5,4,5,5,5,5,"4, 5, 5, 5, 5, 4",4,5,5,5,5,4,1.33,4.67,"5,5,7,1,4,4,3,5,5,1,1,1,1,4,4,1,1",5,5,7,1,4,4,3,5,5,1,1,1,1,4,4,1,1,1,2.5,3.25,4.33,3.50,4.42,2.625,"5,1,1,5,1,1,3,4",5,1,1,5,1,1,3,4,control,Masculino,22,Pardo,Heterossexual,Solteiro(a),maceió,Sim,unit,Graduação,2021
169a9c00-9e22-11eb-9b7e-0daf340a71ab,1618514927197,1618515346194,stFemale,90,2.555555556,"3,2,3,1,2,2,3,4,3",3,2,3,1,2,2,3,4,3,"4, 5, 5, 5, 5, 3",4,5,5,5,5,3,1.67,4.67,"5,5,5,1,7,7,1,7,2,2,4,3,1,3,3,3,3",5,5,5,1,7,7,1,7,2,2,4,3,1,3,3,3,3,2.666666667,3,3.83,5.00,3.00,5.00,2.75,"2,2,2,3,4,3,3,3",2,2,2,3,4,3,3,3,inBoost,Feminino,21,Negro,Prefiro não Responder,Solteiro(a),Maceió,Sim,UFAL,Graduação,2023
906a5a80-9e30-11eb-9b7e-0daf340a71ab,1618521419844,1618521649027,stMale,170,5,"5,5,5,5,5,5,5,5,5",5,5,5,5,5,5,5,5,5,"4, 2, 2, 4, 3, 1",4,2,2,4,3,1,4.00,3.33,"6,6,6,1,6,5,1,7,1,1,1,5,1,5,5,5,2",6,6,6,1,6,5,1,7,1,1,1,5,1,5,5,5,2,2.333333333,4.25,3.04,5.00,2.50,5.25,5,"5,5,5,5,5,5,5,5",5,5,5,5,5,5,5,5,inThreat,Feminino,18,Branco,Heterossexual,Solteiro(a),Maceio,Sim,UFAL,Graduação,2026
bb421410-9e34-11eb-9b7e-0daf340a71ab,1618526737811,1618527015960,default,40,3.625,"3,3,5,2,5,5,1,,5",3,3,5,2,5,5,1,,5,"5, 5, 5, 3, 5, 3",5,5,5,3,5,3,1.67,4.33,"1,1,1,1,1,1,7,7,7,7,3,1,1,7,7,7,7",1,1,1,1,1,1,7,7,7,7,3,1,1,7,7,7,7,1.666666667,7,1.33,1.00,7.00,1.00,5,"5,5,5,5,5,5,5,5",5,5,5,5,5,5,5,5,control,Feminino,17,Branco,Heterossexual,Solteiro(a),,Não,,,
46f906c0-9e36-11eb-9b7e-0daf340a71ab,1618523754311,1618524035226,default,30,3.888888889,"4,3,5,4,3,3,5,5,3",4,3,5,4,3,3,5,5,3,"2, 2, 3, 3, 5, 1",2,2,3,3,5,1,3.33,2.67,"1,2,1,1,6,6,1,1,1,1,3,5,3,3,1,1,1",1,2,1,1,6,6,1,1,1,1,3,5,3,3,1,1,1,3.666666667,1.5,5.08,2.83,1.00,4.92,1.875,"4,4,1,2,1,1,1,1",4,4,1,2,1,1,1,1,control,Feminino,24,Pardo,Heterossexual,Solteiro(a),Maceió,Sim,UFAL,Graduação,2024
09bbd000-9e39-11eb-9b7e-0daf340a71ab,1618524679567,1618525250184,stMale,190,4.333333333,"4,5,4,4,5,4,5,5,3",4,5,4,4,5,4,5,5,3,"5, 5, 4, 5, 4, 4",5,5,4,5,4,4,1.67,4.67,"5,1,2,1,4,1,7,7,7,7,1,1,1,6,6,7,7",5,1,2,1,4,1,7,7,7,7,1,1,1,6,6,7,7,1,6.5,1.25,2.33,7.00,1.67,4.875,"5,4,5,5,5,5,5,5",5,4,5,5,5,5,5,5,inBoost,Masculino,21,Branco,Heterossexual,Solteiro(a),São Paulo,Sim,UFAL,Graduação,2022
936fd080-9e6b-11eb-9b7e-0daf340a71ab,1618545834282,1618546931980,stFemale,180,3.777777778,"4,1,4,3,4,4,5,4,5",4,1,4,3,4,4,5,4,5,"4, 2, 2, 3, 1, 1",4,2,2,3,1,1,4.67,3.00,"4,1,4,1,7,2,6,6,6,4,2,2,1,7,7,6,6",4,1,4,1,7,2,6,6,6,4,2,2,1,7,7,6,6,1.666666667,6.5,1.58,3.17,5.50,2.83,4.625,"4,5,5,4,5,4,5,5",4,5,5,4,5,4,5,5,inBoost,Feminino,25,Branco,Heterossexual,Solteiro(a),Marechal Deodoro,Sim,UFAL,Graduação,2023
08861510-9ebb-11eb-9b7e-0daf340a71ab,1618580786711,1618581023344,stMale,60,3.777777778,"4,3,4,5,4,3,3,4,4",4,3,4,5,4,3,3,4,4,"4, 5, 4, 4, 5, 5",4,5,4,4,5,5,1.00,4.00,"4,2,4,1,3,1,5,6,3,3,3,3,1,4,4,4,4",4,2,4,1,3,1,5,6,3,3,3,3,1,4,4,4,4,2.333333333,4,3.17,2.50,4.25,3.13,3.25,"4,3,3,1,3,4,4,4",4,3,3,1,3,4,4,4,inThreat,Feminino,24,Negro,Heterossexual,Solteiro(a),,Sim,,Outros,2022
7ac290a0-a437-11eb-8cbb-599e427a3fce,1619183733777,1619184236905,default,140,3.555555556,"3,3,4,5,3,3,5,3,3",3,3,4,5,3,3,5,3,3,"3, 4, 2, 2, 4, 4",3,4,2,2,4,4,2.00,2.33,"5,3,5,1,5,4,3,7,5,7,4,4,1,2,4,4,3",5,3,5,1,5,4,3,7,5,7,4,4,1,2,4,4,3,3,3.25,3.88,3.83,5.50,3.17,3.625,"4,5,3,3,4,3,3,4",4,5,3,3,4,3,3,4,control,Masculino,54,Pardo,Heterossexual,Casado(a),Alfenas,Sim,UFOP,Mestrado,2021
1160f4b0-a439-11eb-8cbb-599e427a3fce,1619184152491,1619184697698,stMale,110,4.777777778,"5,5,4,5,4,5,5,5,5",5,5,4,5,4,5,5,5,5,"3, 5, 3, 3, 5, 3",3,5,3,3,5,3,1.67,3.00,"6,6,7,5,7,7,3,6,5,2,6,6,6,2,4,2,2",6,6,7,5,7,7,3,6,5,2,6,6,6,2,4,2,2,6,2.5,5.75,6.33,4.00,5.17,3,"4,4,2,5,2,1,2,4",4,4,2,5,2,1,2,4,inBoost,Masculino,47,Pardo,Heterossexual,Casado(a),MANAUS,Sim,IBAC,Outros,2022
a4947eb0-a456-11eb-8cbb-599e427a3fce,1619197004062,1619197615203,default,170,4.444444444,"4,4,4,5,4,5,4,5,5",4,4,4,5,4,5,4,5,5,"3, 4, 4, 5, 5, 5",3,4,4,5,5,5,1.33,4.00,"1,1,3,1,3,1,6,6,4,6,2,3,1,5,5,4,6",1,1,3,1,3,1,6,6,4,6,2,3,1,5,5,4,6,2,5,2.50,1.67,5.50,2.08,4.75,"5,5,5,5,5,4,5,4",5,5,5,5,5,4,5,4,control,Feminino,29,Branco,Heterossexual,Solteiro(a),Jandira,Sim,Universidade de São Paulo,Graduação,2022
9186bb20-a47f-11eb-8cbb-599e427a3fce,1619213901074,1619215154099,stMale,190,2.666666667,"3,3,2,2,3,2,3,3,3",3,3,2,2,3,2,3,3,3,"4, 3, 4, 5, 5, 5",4,3,4,5,5,5,1.67,4.33,"3,3,3,2,4,4,2,2,2,2,2,3,3,3,3,2,2",3,3,3,2,4,4,2,2,2,2,2,3,3,3,3,2,2,2.666666667,2.5,4.08,3.17,2.00,4.58,3.5,"4,5,4,2,3,3,2,5",4,5,4,2,3,3,2,5,inThreat,Feminino,53,Branco,Heterossexual,Divorciado(a),São Paulo,Não,,Mestrado,
a5bebe50-a48c-11eb-8cbb-599e427a3fce,1619220170772,1619220799188,stMale,140,3.222222222,"3,3,3,4,3,4,3,3,3",3,3,3,4,3,4,3,3,3,"4, 3, 4, 4, 3, 2",4,3,4,4,3,2,3.33,4.00,"5,4,4,3,4,3,5,6,4,4,3,3,3,6,6,6,6",5,4,4,3,4,3,5,6,4,4,3,3,3,6,6,6,6,3,6,2.50,3.83,4.75,3.54,4.75,"5,5,5,4,4,5,5,5",5,5,5,4,4,5,5,5,inThreat,Feminino,52,Branco,Heterossexual,Casado(a),Brasilia,Não,,Graduação,
eb7bfbc0-a79c-11eb-8cbb-599e427a3fce,1619557311077,1619557707080,default,170,3.333333333,"4,3,4,4,2,3,2,4,4",4,3,4,4,2,3,2,4,4,"3, 5, 3, 2, 5, 4",3,5,3,2,5,4,1.33,2.67,"2,2,2,2,3,1,5,6,4,4,3,2,2,4,3,,5",2,2,2,2,3,1,5,6,4,4,3,2,2,4,3,,5,2.333333333,4,3.17,2.00,4.75,2.63,3.375,"4,5,4,2,3,4,2,3",4,5,4,2,3,4,2,3,control,Masculino,23,Branco,Heterossexual,Solteiro(a),Campo Grande,Sim,Universidade Federal do Mato Grosso do Sul,Graduação,2022
d7506eb0-a81e-11eb-8cbb-599e427a3fce,1619612894550,1619613468097,default,170,3.666666667,"4,4,2,5,1,3,4,5,5",4,4,2,5,1,3,4,5,5,"4, 5, 3, 2, 5, 5",4,5,3,2,5,5,1.00,3.00,"1,2,1,1,4,6,3,6,1,4,5,5,5,2,6,6,7",1,2,1,1,4,6,3,6,1,4,5,5,5,2,6,6,7,5,5.25,3.88,2.50,3.50,3.50,3.75,"5,2,2,5,5,4,3,4",5,2,2,5,5,4,3,4,control,Masculino,24,Branco,Heterossexual,Solteiro(a),Campo Grande,Sim,UFMS,Graduação,
0cae3c90-a81f-11eb-8cbb-599e427a3fce,1619613135745,1619613581292,stFemale,150,2.444444444,"4,1,3,2,2,3,2,1,4",4,1,3,2,2,3,2,1,4,"4, 5, 2, 5, 5, 5",4,5,2,5,5,5,1.00,3.67,"1,1,1,1,3,1,4,4,4,4,1,2,1,4,4,4,4",1,1,1,1,3,1,4,4,4,4,1,2,1,4,4,4,4,1.333333333,4,2.67,1.33,4.00,2.67,4,"5,5,3,1,5,5,3,5",5,5,3,1,5,5,3,5,inBoost,Feminino,19,Branco,Heterossexual,Solteiro(a),Campo Grande,Sim,UFMS,Graduação,2024
48ed6aa0-a824-11eb-8cbb-599e427a3fce,1619614119186,1619615819166,stFemale,140,3,"4,3,3,2,3,3,4,3,2",4,3,3,2,3,3,4,3,2,"3, 1, 2, 1, 3, 3",3,1,2,1,3,3,3.67,2.00,"1,1,1,1,5,1,2,4,4,6,2,2,1,3,3,3,6",1,1,1,1,5,1,2,4,4,6,2,2,1,3,3,3,6,1.666666667,3.75,2.96,1.67,4.00,2.83,3.375,"5,5,4,1,3,4,3,2",5,5,4,1,3,4,3,2,inThreat,Masculino,26,Branco,Assexual,Solteiro(a),Campo Grande,Sim,UFMS,Graduação,2023
b5e0a910-a833-11eb-8cbb-599e427a3fce,1619622138242,1619622726081,stMale,170,3.444444444,"4,2,4,3,3,3,3,4,5",4,2,4,3,3,3,3,4,5,"4, 4, 3, 4, 5, 5",4,4,3,4,5,5,1.33,3.67,"2,2,4,1,2,5,2,5,2,6,2,2,1,6,6,6,4",2,2,4,1,2,5,2,5,2,6,2,2,1,6,6,6,4,1.666666667,5.5,2.08,2.67,3.75,3.46,3.875,"3,4,3,4,5,3,5,4",3,4,3,4,5,3,5,4,inBoost,Masculino,20,Branco,Heterossexual,Solteiro(a),Campo Grande,Sim,Universidade Federal Do Mato Grosso Do Sul,Graduação,2024
b70e56d0-a837-11eb-8cbb-599e427a3fce,1619623644257,1619624160660,stFemale,190,3.111111111,"3,2,4,4,5,3,1,1,5",3,2,4,4,5,3,1,1,5,"4, 3, 2, 2, 2, 2",4,3,2,2,2,2,3.67,2.67,"1,1,2,3,,2,6,6,7,7,2,2,2,1,1,1,4",1,1,2,3,,2,6,6,7,7,2,2,2,1,1,1,4,2,1.75,4.13,1.80,6.50,1.65,3.875,"5,2,4,2,5,4,4,5",5,2,4,2,5,4,4,5,inThreat,Masculino,18,Branco,Prefiro não Responder,Solteiro(a),Campo Grande - MS,Sim,UFMS,Graduação,2025
d1fc0bc0-a848-11eb-8cbb-599e427a3fce,1619630821705,1619631258387,default,120,2.888888889,"2,4,4,2,2,1,5,5,1",2,4,4,2,2,1,5,5,1,"4, 5, 5, 5, 5, 5",4,5,5,5,5,5,1.00,4.67,"5,5,5,1,6,1,5,5,5,1,3,3,1,2,4,2,4",5,5,5,1,6,1,5,5,5,1,3,3,1,2,4,2,4,2.333333333,3,3.67,3.83,4.00,3.92,4.625,"4,5,5,5,5,5,5,3",4,5,5,5,5,5,5,3,control,Masculino,23,Pardo,Homossexual,Solteiro(a),CAMPO GRANDE,Sim,UFMS,Graduação,2023
a9467110-a853-11eb-8cbb-599e427a3fce,1619635076676,1619636139028,default,190,2.333333333,"3,2,2,3,1,1,1,5,3",3,2,2,3,1,1,1,5,3,"1, 1, 1, 1, 5, 2",1,1,1,1,5,2,3.33,1.00,"2,2,2,1,5,4,6,6,6,6,1,1,1,1,1,1,2",2,2,2,1,5,4,6,6,6,6,1,1,1,1,1,1,2,1,1.25,3.88,2.67,6.00,2.33,3.375,"5,5,3,2,1,3,3,5",5,5,3,2,1,3,3,5,control,Masculino,19,Branco,Bissexual,Solteiro(a),Campo Grande,Sim,UFMS,Graduação,2024
da329100-aeb6-11eb-8cbb-599e427a3fce,1620337827048,1620338354837,default,160,3.444444444,"4,2,4,3,4,2,4,3,5",4,2,4,3,4,2,4,3,5,"3, 5, 4, 4, 2, 3",3,5,4,4,2,3,2.67,3.67,"1,1,2,1,4,1,5,5,4,5,2,2,1,5,5,4,5",1,1,2,1,4,1,5,5,4,5,2,2,1,5,5,4,5,1.666666667,4.75,2.46,1.67,4.75,2.46,3.375,"3,5,3,1,4,3,3,5",3,5,3,1,4,3,3,5,control,Feminino,22,Pardo,Heterossexual,Solteiro(a),Maceió,Sim,UFAL,Graduação,2022
eb0ea380-aeb9-11eb-8cbb-599e427a3fce,1620339251971,1620339719942,stMale,100,3.555555556,"3,1,5,5,4,4,3,5,2",3,1,5,5,4,4,3,5,2,"3, 2, 4, 4, 1, 1",3,2,4,4,1,1,4.67,3.67,"6,4,7,1,3,1,7,5,7,7,1,1,1,5,5,5,5",6,4,7,1,3,1,7,5,7,7,1,1,1,5,5,5,5,1,5,2.00,3.67,6.50,2.58,4.875,"5,5,5,5,4,5,5,5",5,5,5,5,4,5,5,5,inBoost,Masculino,49,Branco,Heterossexual,Casado(a),Jaboatão dos Guararapes,Sim,IFPE,Doutorado,2026
3d203cb0-af41-11eb-b944-15c8c1c6ce71,1620397310059,1620397854960,stMale,180,3.444444444,"3,1,5,3,5,5,1,5,3",3,1,5,3,5,5,1,5,3,"5, 5, 5, 5, 5, 4",5,5,5,5,5,4,1.33,5.00,"4,5,6,1,3,6,2,7,2,4,3,3,1,7,7,7,5",4,5,6,1,3,6,2,7,2,4,3,3,1,7,7,7,5,2.333333333,6.5,1.92,4.17,3.75,4.21,4.75,"4,5,5,5,5,5,4,5",4,5,5,5,5,5,4,5,inThreat,Feminino,25,Negro,Homossexual,Solteiro(a),Maceió,Não,Universidade Federal de Alagoas,Graduação,
e7bb7ec0-b057-11eb-b944-15c8c1c6ce71,1620517330346,1620517608178,default,50,3.4,",,,,1,3,5,4,4",,,,,1,3,5,4,4,"3, 3, 3, 3, 3, 3",3,3,3,3,3,3,3.00,3.00,"1,1,1,1,1,1,6,6,6,6,1,1,1,4,4,6,6",1,1,1,1,1,1,6,6,6,6,1,1,1,4,4,6,6,1,5,2.00,1.00,6.00,1.50,4,"5,5,5,5,3,3,3,3",5,5,5,5,3,3,3,3,control,Masculino,30,Branco,Heterossexual,Solteiro(a),Cuiabá,Sim,Ufmt,Graduação,2025
8a1d24d0-b183-11eb-b944-15c8c1c6ce71,1620645395912,1620646240228,stFemale,150,4.111111111,"3,2,5,4,5,4,5,5,4",3,2,5,4,5,4,5,5,4,"3, 3, 5, 5, 2, 2",3,3,5,5,2,2,3.67,4.33,"2,1,2,1,3,1,6,7,7,7,1,1,1,4,4,4,7",2,1,2,1,3,1,6,7,7,7,1,1,1,4,4,4,7,1,4.75,2.13,1.67,6.75,1.46,4.125,"5,5,4,3,5,4,2,5",5,5,4,3,5,4,2,5,inThreat,Masculino,56,Branco,Heterossexual,Divorciado(a),Itajaí,Sim,UNIVALI,Mestrado,2022
5ca44270-b19e-11eb-b944-15c8c1c6ce71,1620657461650,1620657859299,default,40,3.888888889,"3,5,5,5,3,3,1,5,5",3,5,5,5,3,3,1,5,5,"2, 5, 5, 5, 5, 5",2,5,5,5,5,5,1.00,4.00,"1,,7,7,7,7,3,6,1,7,7,7,7,7,7,1,1",1,,7,7,7,7,3,6,1,7,7,7,7,7,7,1,1,7,4,5.50,5.80,4.25,4.78,3,"2,5,3,5,2,2,2,3",2,5,3,5,2,2,2,3,control,Feminino,21,Pardo,Heterossexual,Solteiro(a),,Sim,Ufal,Graduação,2025
c5d98fb0-b1c7-11eb-b944-15c8c1c6ce71,1620674228832,1620675578697,default,160,3.444444444,"4,1,4,5,3,4,4,2,4",4,1,4,5,3,4,4,2,4,"3, 4, 4, 4, 3, 2",3,4,4,4,3,2,3.00,3.67,"1,1,1,1,4,1,4,4,4,5,1,1,1,1,1,1,6",1,1,1,1,4,1,4,4,4,5,1,1,1,1,1,1,6,1,2.25,3.38,1.50,4.25,2.63,3.125,"5,2,4,1,4,4,3,2",5,2,4,1,4,4,3,2,control,Feminino,19,Branco,Heterossexual,Prefiro não Responder,Maceió,Sim,UFAL,Graduação,2024
d79c21e0-b1db-11eb-b944-15c8c1c6ce71,1620683172964,1620684245218,stMale,170,2.777777778,"4,1,3,2,4,3,4,2,2",4,1,3,2,4,3,4,2,2,"3, 4, 3, 3, 5, 4",3,4,3,3,5,4,1.67,3.00,"1,1,4,2,4,2,5,5,6,6,5,5,2,2,2,2,7",1,1,4,2,4,2,5,5,6,6,5,5,2,2,2,2,7,4,3.25,4.38,2.33,5.50,2.42,3.875,"5,4,5,2,2,5,3,5",5,4,5,2,2,5,3,5,inBoost,Masculino,21,Pardo,Heterossexual,Solteiro(a),Sobradinho,Sim,UnB,Graduação,2023
16027280-b1dd-11eb-b944-15c8c1c6ce71,1620683621288,1620684627288,default,180,3.777777778,"5,3,4,4,5,4,4,2,3",5,3,4,4,5,4,4,2,3,"4, 3, 2, 4, 3, 3",4,3,2,4,3,3,3.00,3.33,"4,2,2,1,3,2,6,6,6,5,1,2,1,6,2,5,7",4,2,2,1,3,2,6,6,6,5,1,2,1,6,2,5,7,1.333333333,5,2.17,2.33,5.75,2.29,4.25,"5,4,5,2,5,4,4,5",5,4,5,2,5,4,4,5,control,Masculino,24,Pardo,Heterossexual,Solteiro(a),Brasília,Sim,Universidade de Brasília,Graduação,2022
8eba26c0-b1ea-11eb-b944-15c8c1c6ce71,1620690086378,1620690468124,default,170,2.888888889,"3,2,2,4,5,2,2,3,3",3,2,2,4,5,2,2,3,3,"2, 5, 3, 2, 4, 3",2,5,3,2,4,3,2.00,2.33,"1,1,1,1,3,1,4,4,4,6,2,1,1,1,2,1,4",1,1,1,1,3,1,4,4,4,6,2,1,1,1,2,1,4,1.333333333,2,3.67,1.33,4.50,2.42,2.75,"5,5,3,1,1,2,2,3",5,5,3,1,1,2,2,3,control,Masculino,19,Branco,Assexual,Solteiro(a),Brasília,Sim,Universidade de Brasília,Graduação,2026
3cbe7e50-b25a-11eb-b944-15c8c1c6ce71,1620738047180,1620738541480,default,150,4.111111111,"5,4,5,4,4,3,3,5,4",5,4,5,4,4,3,3,5,4,"4, 4, 4, 2, 5, 5",4,4,4,2,5,5,1.33,3.33,"1,1,1,1,2,1,7,7,1,1,1,1,1,5,6,4,7",1,1,1,1,2,1,7,7,1,1,1,1,1,5,6,4,7,1,5.5,1.75,1.17,4.00,2.58,4,"5,1,5,4,5,5,4,3",5,1,5,4,5,5,4,3,control,Masculino,23,Branco,Heterossexual,Solteiro(a),Paranoá,Sim,Universidade de Brasilia,Graduação,2022
77a7a000-b264-11eb-b944-15c8c1c6ce71,1620742554261,1620742929559,stMale,170,3.111111111,"4,3,4,3,2,2,2,4,4",4,3,4,3,2,2,2,4,4,"3, 2, 2, 2, 2, 2",3,2,2,2,2,2,4.00,2.33,"2,2,3,1,3,3,5,7,4,6,1,2,1,6,4,3,5",2,2,3,1,3,3,5,7,4,6,1,2,1,6,4,3,5,1.333333333,4.5,2.42,2.33,5.50,2.42,2.625,"4,1,4,2,1,3,3,3",4,1,4,2,1,3,3,3,inBoost,Masculino,22,Pardo,Heterossexual,Solteiro(a),Taguatinga,Sim,Universidade de Brasilia,Graduação,2022
108b6210-b649-11eb-ad27-3593da35795f,1621169857497,1621170870685,default,170,4.888888889,"5,5,5,5,5,5,5,4,5",5,5,5,5,5,5,5,4,5,"4, 5, 4, 5, 5, 3",4,5,4,5,5,3,1.67,4.33,"1,1,1,1,2,1,7,7,6,1,1,1,1,7,2,7,7",1,1,1,1,2,1,7,7,6,1,1,1,1,7,2,7,7,1,5.75,1.63,1.17,5.25,1.96,4.5,"5,5,5,1,5,5,5,5",5,5,5,1,5,5,5,5,control,Masculino,27,Negro,Heterossexual,Solteiro(a),BRASILIA,Sim,universidade de brasília,Graduação,20222
08506260-b812-11eb-93e6-43229aa359ae,1621365406713,1621367195820,stMale,110,3,"4,5,2,1,2,1,4,5,3",4,5,2,1,2,1,4,5,3,"3, 1, 1, 4, 1, 1",3,1,1,4,1,1,5.00,2.67,"3,3,3,6,7,4,4,2,6,6,4,3,5,4,3,5,5",3,3,3,6,7,4,4,2,6,6,4,3,5,4,3,5,5,4,4.25,3.88,4.33,4.50,3.92,2.875,"2,4,3,4,3,2,3,2",2,4,3,4,3,2,3,2,inBoost,Masculino,26,Branco,Heterossexual,Solteiro(a),Ceilândia,Sim,UnB,,
65ae5870-b819-11eb-93e6-43229aa359ae,1621369944618,1621370358940,stFemale,140,3,"4,3,3,5,3,1,1,5,2",4,3,3,5,3,1,1,5,2,"3, 5, 2, 1, 5, 4",3,5,2,1,5,4,1.33,2.00,"1,1,7,1,7,6,1,1,1,4,1,5,1,1,1,1,1",1,1,7,1,7,6,1,1,1,4,1,5,1,1,1,1,1,2.333333333,1,4.67,3.83,1.75,5.04,2.25,"5,1,2,5,1,1,2,1",5,1,2,5,1,1,2,1,inThreat,Masculino,20,Pardo,Heterossexual,Solteiro(a),Feira Grande - AL,Sim,UFAL,Graduação,2026
5f6ad630-b825-11eb-93e6-43229aa359ae,1621375094890,1621375508474,stMale,140,3,"3,1,5,3,2,2,1,5,5",3,1,5,3,2,2,1,5,5,"3, 1, 5, 3, 5, 5",3,1,5,3,5,5,2.33,3.67,"7,7,7,3,4,7,1,7,1,1,3,3,3,6,6,6,1",7,7,7,3,4,7,1,7,1,1,3,3,3,6,6,6,1,3,4.75,3.13,5.83,2.50,5.67,3.5,"5,1,5,1,5,4,3,4",5,1,5,1,5,4,3,4,inThreat,Feminino,23,Pardo,Heterossexual,Solteiro(a),Maribondo,Sim,Ufal,Graduação,2023
63642710-b829-11eb-93e6-43229aa359ae,1621376622399,1621377222178,stFemale,170,3.555555556,"3,2,4,4,3,3,4,4,5",3,2,4,4,3,3,4,4,5,"4, 5, 5, 4, 5, 4",4,5,5,4,5,4,1.33,4.33,"1,1,2,1,3,2,5,7,4,4,4,2,1,1,3,3,4",1,1,2,1,3,2,5,7,4,4,4,2,1,1,3,3,4,2.333333333,2.75,3.79,1.67,5.00,2.33,3.75,"3,4,4,2,5,4,3,5",3,4,4,2,5,4,3,5,inBoost,Feminino,33,Pardo,Heterossexual,Solteiro(a),Maceió,Sim,UFAL,Graduação,2021
8fe50750-b82e-11eb-93e6-43229aa359ae,1621378457469,1621379414540,stMale,170,3.555555556,"4,3,4,4,4,3,4,4,2",4,3,4,4,4,3,4,4,2,"3, 4, 4, 4, 5, 5",3,4,4,4,5,5,1.33,3.67,"3,2,3,1,3,2,6,6,5,6,2,2,1,5,6,6,6",3,2,3,1,3,2,6,6,5,6,2,2,1,5,6,6,6,1.666666667,5.75,1.96,2.33,5.75,2.29,4,"4,3,4,4,5,4,4,4",4,3,4,4,5,4,4,4,inBoost,Masculino,24,Branco,Heterossexual,Solteiro(a),Maceió,Sim,UFAL,Graduação,2026
92d0f4f0-b834-11eb-93e6-43229aa359ae,1621381184774,1621382048968,default,130,3.555555556,"4,3,4,3,3,3,3,5,4",4,3,4,3,3,3,3,5,4,"2, 4, 4, 3, 4, 4",2,4,4,3,4,4,2.00,3.00,"6,5,6,4,7,5,2,4,1,2,4,2,3,2,2,1,1",6,5,6,4,7,5,2,4,1,2,4,2,3,2,2,1,1,3,1.5,4.75,5.50,2.25,5.63,2.25,"2,3,2,5,2,1,1,2",2,3,2,5,2,1,1,2,control,Feminino,23,Negro,Prefiro não Responder,Solteiro(a),Maceió,Sim,UFAL,Graduação,2025
a17bb480-bf06-11eb-93e6-43229aa359ae,1622128933140,1622131697258,stMale,190,3,"3,3,3,3,3,3,3,3,3",3,3,3,3,3,3,3,3,3,"3, 3, 3, 3, 3, 3",3,3,3,3,3,3,3.00,3.00,"2,2,2,1,3,1,6,6,6,6,2,2,2,6,5,6,6",2,2,2,1,3,1,6,6,6,6,2,2,2,6,5,6,6,2,5.75,2.13,1.83,6.00,1.92,4.375,"5,4,5,4,5,4,4,4",5,4,5,4,5,4,4,4,inBoost,Masculino,20,Pardo,Heterossexual,Solteiro(a),,Sim,UnB,Graduação,
b86c5a00-c0be-11eb-93e6-43229aa359ae,1622320344479,1622320983017,default,180,3.222222222,"3,3,4,4,3,3,5,2,2",3,3,4,4,3,3,5,2,2,"4, 4, 3, 4, 5, 4",4,4,3,4,5,4,1.67,3.67,"2,2,2,2,3,3,6,7,6,6,3,3,1,6,5,5,6",2,2,2,2,3,3,6,7,6,6,3,3,1,6,5,5,6,2.333333333,5.5,2.42,2.33,6.25,2.04,4.25,"5,4,5,1,5,4,5,5",5,4,5,1,5,4,5,5,control,Masculino,23,Branco,Heterossexual,Solteiro(a),Maceió - AL,Sim,UFPE,Graduação,2023
0ed06520-c18d-11eb-93e6-43229aa359ae,1622409002885,1622409620393,stMale,180,3,"3,2,3,3,2,2,4,4,4",3,2,3,3,2,2,4,4,4,"4, 4, 3, 4, 4, 3",4,4,3,4,4,3,2.33,3.67,"4,5,5,2,5,3,5,5,5,4,3,2,2,5,5,4,4",4,5,5,2,5,3,5,5,5,4,3,2,2,5,5,4,4,2.333333333,4.5,2.92,4.00,4.75,3.63,4.5,"5,5,4,4,5,5,4,4",5,5,4,4,5,5,4,4,inBoost,Masculino,39,Branco,Heterossexual,União estável,Joinville,Sim,Udesc - Joinville,Graduação,2006
12bc0350-c463-11eb-9261-891d55fc2af9,1622720539000,1622721230505,stMale,110,4.111111111,"4,2,5,4,5,4,4,5,4",4,2,5,4,5,4,4,5,4,"4, 4, 3, 4, 5, 5",4,4,3,4,5,5,1.33,3.67,"1,1,1,1,2,1,7,7,7,7,4,4,1,5,4,4,4",1,1,1,1,2,1,7,7,7,7,4,4,1,5,4,4,4,3,4.25,3.38,1.17,7.00,1.08,3.625,"3,3,4,4,4,4,3,4",3,3,4,4,4,4,3,4,inThreat,Feminino,56,Pardo,Heterossexual,Solteiro(a),Maceió,Sim,UFAL,Outros,
c5628d20-c7cf-11eb-9261-891d55fc2af9,1623095914841,1623097598250,stMale,170,3.666666667,"4,3,5,4,4,3,3,2,5",4,3,5,4,4,3,3,2,5,"3, 5, 4, 4, 5, 4",3,5,4,4,5,4,1.33,3.67,"5,1,1,1,6,1,6,6,7,6,2,2,1,3,3,2,3",5,1,1,1,6,1,6,6,7,6,2,2,1,3,3,2,3,1.666666667,2.75,3.46,2.50,6.25,2.13,3.75,"4,3,3,5,4,3,3,5",4,3,3,5,4,3,3,5,inThreat,Feminino,24,Pardo,Homossexual,Solteiro(a),Jaru,Sim,UPAP,Graduação,10
cc9a1970-dba5-11eb-916d-ef9a5fc9a834,1625278319917,1625278970072,stFemale,160,3.666666667,"4,4,4,3,2,4,2,5,5",4,4,4,3,2,4,2,5,5,"4, 5, 4, 3, 4, 4",4,5,4,3,4,4,1.67,3.67,"6,6,6,4,6,5,3,6,3,5,4,5,5,4,6,5,7",6,6,6,4,6,5,3,6,3,5,4,5,5,4,6,5,7,4.666666667,5.5,3.58,5.50,4.25,4.63,4,"5,3,5,4,4,4,4,3",5,3,5,4,4,4,4,3,inBoost,Feminino,21,Prefiro não Responder,Bissexual,Solteiro(a),Maceió,Sim,UFAL,Graduação,2022
fc1e63c0-dbac-11eb-916d-ef9a5fc9a834,1625280266099,1625281729259,default,150,2.555555556,"3,2,4,2,2,1,2,4,3",3,2,4,2,2,1,2,4,3,"3, 4, 3, 3, 5, 4",3,4,3,3,5,4,1.67,3.00,"1,1,3,1,5,1,5,7,6,6,6,6,2,2,3,2,6",1,1,3,1,5,1,5,7,6,6,6,6,2,2,3,2,6,4.666666667,3.25,4.71,2.00,6.00,2.00,3.625,"4,4,4,1,5,5,4,2",4,4,4,1,5,5,4,2,control,Feminino,19,Negro,Heterossexual,Solteiro(a),Paripueira,Sim,UFAL,Graduação,2025
b7ecef30-dbf9-11eb-916d-ef9a5fc9a834,1625314435990,1625314990128,default,170,3.333333333,"3,3,4,4,3,4,3,2,4",3,3,4,4,3,4,3,2,4,"4, 3, 4, 3, 2, 2",4,3,4,3,2,2,3.67,3.67,"1,1,1,1,2,1,7,7,7,7,1,1,1,4,4,4,7",1,1,1,1,2,1,7,7,7,7,1,1,1,4,4,4,7,1,4.75,2.13,1.17,7.00,1.08,3.75,"4,5,5,1,3,3,4,5",4,5,5,1,3,3,4,5,control,Feminino,20,Pardo,Heterossexual,Solteiro(a),Salvador,Sim,UFAL,Graduação,2023
4ca8d3a0-dc27-11eb-916d-ef9a5fc9a834,1625334003218,1625334563305,default,160,3.222222222,"4,2,4,3,1,3,4,5,3",4,2,4,3,1,3,4,5,3,"3, 2, 4, 2, 5, 3",3,2,4,2,5,3,2.67,3.00,"1,1,2,2,3,1,4,5,3,6,2,1,1,3,4,2,4",1,1,2,2,3,1,4,5,3,6,2,1,1,3,4,2,4,1.333333333,3.25,3.04,1.67,4.50,2.58,3.875,"4,5,3,5,5,5,2,2",4,5,3,5,5,5,2,2,control,Masculino,21,Negro,Heterossexual,Solteiro(a),Coruripe,Sim,Instituto da Computação,Graduação,2025
8b51aea0-df61-11eb-bf23-972ef7bdc96c,1625689115410,1625689435899,stMale,100,3.111111111,"3,4,4,3,3,3,4,1,3",3,4,4,3,3,3,4,1,3,"4, 5, 3, 3, 5, 4",4,5,3,3,5,4,1.33,3.33,"3,1,1,1,4,2,6,6,7,5,2,3,1,4,5,4,7",3,1,1,1,4,2,6,6,7,5,2,3,1,4,5,4,7,2,5,2.50,2.00,6.00,2.00,3.75,"4,5,4,1,4,4,3,5",4,5,4,1,4,4,3,5,inBoost,Masculino,20,Pardo,Heterossexual,Solteiro(a),Maceió,Sim,UFAL,Graduação,2024
c2104500-df61-11eb-bf23-972ef7bdc96c,1625689144337,1625689576895,default,120,3.666666667,"3,2,5,3,4,3,5,4,4",3,2,5,3,4,3,5,4,4,"3, 5, 3, 4, 5, 3",3,5,3,4,5,3,1.67,3.33,"2,2,3,2,5,1,4,4,3,2,3,2,,4,3,4,4",2,2,3,2,5,1,4,4,3,2,3,2,,4,3,4,4,2.5,3.75,3.38,2.50,3.25,3.63,3.25,"4,5,3,2,4,3,3,2",4,5,3,2,4,3,3,2,control,Masculino,18,Pardo,Heterossexual,Solteiro(a),Rio Largo,Sim,UFAL,Graduação,2023
d7a07110-df61-11eb-bf23-972ef7bdc96c,1625689130492,1625689607343,stFemale,200,3.888888889,"4,2,4,5,3,3,5,5,4",4,2,4,5,3,3,5,5,4,"2, 3, 2, 2, 5, 3",2,3,2,2,5,3,2.33,2.00,"1,1,1,1,3,5,2,7,3,7,1,1,1,1,1,1,4",1,1,1,1,3,5,2,7,3,7,1,1,1,1,1,1,4,1,1.75,3.63,2.00,4.75,2.63,3.25,"5,5,5,1,1,3,1,5",5,5,5,1,1,3,1,5,inThreat,Masculino,21,Branco,Heterossexual,Solteiro(a),Maceió,Sim,UFAL,Graduação,2025
eacce390-df61-11eb-bf23-972ef7bdc96c,1625689128108,1625689604033,default,160,3.666666667,"3,1,5,4,5,3,5,2,5",3,1,5,4,5,3,5,2,5,"3, 3, 3, 5, 5, 4",3,3,3,5,5,4,2.00,3.67,"2,2,4,2,5,4,6,6,5,5,2,1,1,7,6,6,7",2,2,4,2,5,4,6,6,5,5,2,1,1,7,6,6,7,1.333333333,6.5,1.42,3.17,5.50,2.83,4.125,"4,5,5,1,4,4,5,5",4,5,5,1,4,4,5,5,control,Masculino,18,Pardo,Heterossexual,Solteiro(a),Maceio,Sim,UFAL,Graduação,2026
f343a310-df61-11eb-bf23-972ef7bdc96c,1625689142358,1625689645454,stMale,160,3.222222222,"5,2,3,2,4,2,1,5,5",5,2,3,2,4,2,1,5,5,"3, 1, 4, 4, 5, 3",3,1,4,4,5,3,3.00,3.67,"2,4,2,1,2,4,6,6,5,6,1,1,1,6,4,4,4",2,4,2,1,2,4,6,6,5,6,1,1,1,6,4,4,4,1,4.5,2.25,2.50,5.75,2.38,3.75,"5,1,5,1,5,5,3,5",5,1,5,1,5,5,3,5,inBoost,Masculino,21,Pardo,Heterossexual,Solteiro(a),MACEIÓ,Sim,ufal,Graduação,2025
fe2e21b0-df61-11eb-bf23-972ef7bdc96c,1625689189923,1625689655192,stMale,160,3.333333333,"3,3,4,3,3,4,4,3,3",3,3,4,3,3,4,4,3,3,"3, 3, 3, 3, 3, 3",3,3,3,3,3,3,3.00,3.00,"1,1,1,1,2,1,7,,5,7,1,1,1,4,4,4,4",1,1,1,1,2,1,7,,5,7,1,1,1,4,4,4,4,1,4,2.50,1.17,6.33,1.42,3.625,"5,5,3,1,4,5,3,3",5,5,3,1,4,5,3,3,inBoost,Masculino,23,Branco,Heterossexual,Solteiro(a),União Dos Palmares,Sim,Ufal,Graduação,
fe83e2d0-df61-11eb-bf23-972ef7bdc96c,1625689168344,1625689615181,stFemale,160,3.333333333,"3,1,4,3,4,3,3,4,5",3,1,4,3,4,3,3,4,5,"3, 5, 3, 2, 5, 4",3,5,3,2,5,4,1.33,2.67,"5,4,4,2,5,5,2,4,2,2,3,3,2,7,6,6,5",5,4,4,2,5,5,2,4,2,2,3,3,2,7,6,6,5,2.666666667,6,2.33,4.17,2.50,4.83,4.5,"4,4,5,5,5,4,5,4",4,4,5,5,5,4,5,4,inThreat,Masculino,19,Negro,Heterossexual,Solteiro(a),Rio Largo,Sim,UFAL,Graduação,2024
369d0020-df62-11eb-bf23-972ef7bdc96c,1625689236446,1625689724073,default,140,3.444444444,"3,2,4,3,4,3,2,5,5",3,2,4,3,4,3,2,5,5,"3, 5, 4, 4, 5, 4",3,5,4,4,5,4,1.33,3.67,"4,2,6,1,6,6,2,4,3,3,1,1,1,6,6,6,5",4,2,6,1,6,6,2,4,3,3,1,1,1,6,6,6,5,1,5.75,1.63,4.17,3.00,4.58,4.125,"5,2,3,4,5,5,4,5",5,2,3,4,5,5,4,5,control,Masculino,19,Branco,Heterossexual,Solteiro(a),Maceió,Sim,UFAL,Graduação,2025
3ee27670-df62-11eb-bf23-972ef7bdc96c,1625689186996,1625689720011,default,160,3.555555556,"4,2,3,3,4,3,5,5,3",4,2,3,3,4,3,5,5,3,"2, 5, 3, 4, 4, 3",2,5,3,4,4,3,2.00,3.00,"1,1,1,1,6,1,7,6,7,6,1,1,1,6,6,6,7",1,1,1,1,6,1,7,6,7,6,1,1,1,6,6,6,7,1,6.25,1.38,1.83,6.50,1.67,4.625,"5,5,4,5,5,4,4,5",5,5,4,5,5,4,4,5,control,Masculino,19,Pardo,Heterossexual,Solteiro(a),Maceió - AL,Sim,UFAL,Graduação,2025
4282ceb0-df62-11eb-bf23-972ef7bdc96c,1625689164892,1625689744465,stMale,150,3.777777778,"4,3,4,4,4,5,2,4,4",4,3,4,4,4,5,2,4,4,"4, 5, 3, 4, 5, 5",4,5,3,4,5,5,1.00,3.67,"3,3,4,2,5,1,6,6,6,4,2,2,2,4,2,3,4",3,3,4,2,5,1,6,6,6,4,2,2,2,4,2,3,4,2,3.25,3.38,3.00,5.50,2.75,3.25,"5,4,4,1,3,3,3,3",5,4,4,1,3,3,3,3,inBoost,Masculino,19,Branco,Heterossexual,Solteiro(a),Maceió,Sim,UFAL,Outros,2024
4807c570-df62-11eb-bf23-972ef7bdc96c,1625689305171,1625689740431,default,150,2.555555556,"3,2,3,2,2,2,2,4,3",3,2,3,2,2,2,2,4,3,"4, 4, 3, 3, 5, 4",4,4,3,3,5,4,1.67,3.33,"2,2,3,2,4,3,5,6,3,6,2,1,2,4,2,2,7",2,2,3,2,4,3,5,6,3,6,2,1,2,4,2,2,7,1.666666667,3.75,2.96,2.67,5.00,2.83,3.875,"5,5,4,3,3,4,3,4",5,5,4,3,3,4,3,4,control,Masculino,20,Pardo,Heterossexual,Solteiro(a),Maceió,Sim,Ufal,Graduação,2023
67a97540-df62-11eb-bf23-972ef7bdc96c,1625689265262,1625689772484,stFemale,190,3.5,",,,,,4,3,3,4",,,,,,4,3,3,4,"2, 5, 2, 2, 4, 3",2,5,2,2,4,3,2.00,2.00,"5,4,6,1,5,3,4,4,4,3,1,1,1,6,4,2,4",5,4,6,1,5,3,4,4,4,3,1,1,1,6,4,2,4,1,4,2.50,4.00,3.75,4.13,4.625,"5,5,5,4,5,5,3,5",5,5,5,4,5,5,3,5,inThreat,Masculino,20,Pardo,Heterossexual,Solteiro(a),Maceió,Sim,ufal,Graduação,2025
7cc13d00-df62-11eb-bf23-972ef7bdc96c,1625689253132,1625689884063,stFemale,190,4.111111111,"4,3,5,1,5,4,5,5,5",4,3,5,1,5,4,5,5,5,"5, 3, 5, 3, 5, 5",5,3,5,3,5,5,1.67,4.33,"1,1,2,1,1,1,7,7,4,7,1,1,1,4,4,5,7",1,1,2,1,1,1,7,7,4,7,1,1,1,4,4,5,7,1,5,2.00,1.17,6.25,1.46,4.25,"3,5,5,3,5,5,3,5",3,5,5,3,5,5,3,5,inThreat,Masculino,18,Pardo,Homossexual,Solteiro(a),Maceió,Sim,UFAL,Graduação,2024
890928c0-df62-11eb-bf23-972ef7bdc96c,1625689172640,1625689869152,default,170,4.222222222,"4,4,4,4,5,4,5,4,4",4,4,4,4,5,4,5,4,4,"4, 3, 4, 4, 3, 3",4,3,4,4,3,3,3.00,4.00,"5,4,4,2,5,4,6,6,5,6,3,2,2,5,6,5,6",5,4,4,2,5,4,6,6,5,6,3,2,2,5,6,5,6,2.333333333,5.5,2.42,4.00,5.75,3.13,3.75,"4,4,4,4,4,3,3,4",4,4,4,4,4,3,3,4,control,Masculino,20,Branco,Heterossexual,Solteiro(a),Maceió,Sim,UFAL,Graduação,2023
9bf2ecf0-df62-11eb-bf23-972ef7bdc96c,1625689257833,1625689859604,default,120,2.111111111,"3,2,1,1,1,1,1,5,4",3,2,1,1,1,1,1,5,4,"5, 5, 1, 1, 5, 1",5,5,1,1,5,1,2.33,2.33,"7,7,7,1,7,7,1,1,1,1,1,1,1,7,7,7,1",7,7,7,1,7,7,1,1,1,1,1,1,1,7,7,7,1,1,5.5,1.75,6.00,1.00,6.50,2,"1,1,1,5,1,1,5,1",1,1,1,5,1,1,5,1,control,Masculino,20,Pardo,Heterossexual,Solteiro(a),Maceió,Sim,Universidade Federal de Alagoas - UFAL,Graduação,2024
9f602740-df62-11eb-bf23-972ef7bdc96c,1625689293969,1625689911040,stFemale,140,3.555555556,"4,3,4,3,5,4,2,3,4",4,3,4,3,5,4,2,3,4,"4, 4, 2, 3, 5, 3",4,4,2,3,5,3,2.00,3.00,"5,5,6,3,6,6,3,4,6,3,3,2,2,4,5,5,4",5,5,6,3,6,6,3,4,6,3,3,2,2,4,5,5,4,2.333333333,4.5,2.92,5.17,4.00,4.58,4,"4,4,3,5,5,3,3,5",4,4,3,5,5,3,3,5,inThreat,Masculino,19,Pardo,Heterossexual,Casado(a),Luziápolis (Campo Alegre),Sim,UFAL,Graduação,2024
a2018610-df62-11eb-bf23-972ef7bdc96c,1625689305045,1625689848846,stFemale,130,3.222222222,"4,2,2,3,5,1,2,5,5",4,2,2,3,5,1,2,5,5,"4, 5, 3, 4, 5, 5",4,5,3,4,5,5,1.00,3.67,"6,5,6,5,7,4,4,6,3,5,4,5,3,4,4,4,6",6,5,6,5,7,4,4,6,3,5,4,5,3,4,4,4,6,4,4.5,3.75,5.50,4.50,4.50,2.875,"5,1,3,1,3,4,2,4",5,1,3,1,3,4,2,4,inThreat,Masculino,19,Branco,Heterossexual,Solteiro(a),Maceió,Sim,UFAL,Graduação,
ba97c630-df62-11eb-bf23-972ef7bdc96c,1625689268522,1625689939274,default,170,3.222222222,"1,2,4,3,4,5,5,2,3",1,2,4,3,4,5,5,2,3,"2, 5, 4, 3, 5, 4",2,5,4,3,5,4,1.33,3.00,"3,3,1,1,4,1,6,7,7,6,2,1,1,4,2,4,7",3,3,1,1,4,1,6,7,7,6,2,1,1,4,2,4,7,1.333333333,4.25,2.54,2.17,6.50,1.83,4.25,"5,4,5,1,5,5,5,4",5,4,5,1,5,5,5,4,control,Feminino,19,Branco,Heterossexual,Solteiro(a),barreiros-Pe,Sim,ufal,Graduação,2024
bb4962f0-df62-11eb-bf23-972ef7bdc96c,1625689144081,1625689959093,stMale,200,4.444444444,"4,4,5,5,3,5,5,4,5",4,4,5,5,3,5,5,4,5,"5, 2, 4, 5, 4, 1",5,2,4,5,4,1,3.67,4.67,"4,1,1,1,1,2,1,6,2,2,1,1,1,6,6,5,5",4,1,1,1,1,2,1,6,2,2,1,1,1,6,6,5,5,1,5.5,1.75,1.67,2.75,3.46,4.5,"5,4,5,2,5,5,5,5",5,4,5,2,5,5,5,5,inBoost,Masculino,20,Pardo,Heterossexual,Solteiro(a),MACEIÓ,Sim,ufal,Graduação,2024
ed40fb60-df62-11eb-bf23-972ef7bdc96c,1625689216572,1625689960325,stFemale,130,3.555555556,"3,3,4,3,4,2,4,4,5",3,3,4,3,4,2,4,4,5,"3, 1, 3, 4, 4, 5",3,1,3,4,4,5,2.67,3.33,"2,1,3,1,5,3,6,6,5,6,4,3,1,7,7,7,6",2,1,3,1,5,3,6,6,5,6,4,3,1,7,7,7,6,2.666666667,6.75,1.96,2.50,5.75,2.38,4.625,"5,4,4,5,5,4,5,5",5,4,4,5,5,4,5,5,inBoost,Feminino,19,Branco,Heterossexual,Solteiro(a),Arapiraca,Sim,UFAL,Graduação,2024
20b9dca0-df63-11eb-bf23-972ef7bdc96c,1625689301560,1625690098312,stMale,130,2.444444444,"2,1,2,3,1,3,4,4,2",2,1,2,3,1,3,4,4,2,"4, 4, 4, 4, 5, 4",4,4,4,4,5,4,1.67,4.00,"7,2,6,1,3,3,6,5,3,1,2,2,1,4,6,4,6",7,2,6,1,3,3,6,5,3,1,2,2,1,4,6,4,6,1.666666667,5,2.33,3.67,3.75,3.96,3.875,"5,4,2,5,4,4,3,4",5,4,2,5,4,4,3,4,inBoost,Masculino,26,Negro,Heterossexual,Solteiro(a),Rolim de Moura,Sim,UFAL,Graduação,3
2145a1e0-df63-11eb-bf23-972ef7bdc96c,1625689122808,1625689973314,default,190,4,"4,3,4,4,4,5,5,4,3",4,3,4,4,4,5,5,4,3,"5, 5, 4, 3, 5, 5",5,5,4,3,5,5,1.00,4.00,"1,1,1,1,2,1,7,7,5,6,1,1,1,7,6,5,7",1,1,1,1,2,1,7,7,5,6,1,1,1,7,6,5,7,1,6.25,1.38,1.17,6.25,1.46,4.75,"5,5,5,3,5,5,5,5",5,5,5,3,5,5,5,5,control,Masculino,24,Pardo,Heterossexual,Casado(a),Maceió,Sim,UFAL,Graduação,2025
25210750-df63-11eb-bf23-972ef7bdc96c,1625689608465,1625690090821,stMale,160,4,"5,2,4,5,4,4,4,4,4",5,2,4,5,4,4,4,4,4,"4, 4, 3, 4, 5, 4",4,4,3,4,5,4,1.67,3.67,"5,4,4,2,3,2,6,6,5,4,2,2,2,5,5,4,6",5,4,4,2,3,2,6,6,5,4,2,2,2,5,5,4,6,2,5,2.50,3.33,5.25,3.04,4.375,"5,5,4,4,5,5,3,4",5,5,4,4,5,5,3,4,inBoost,Masculino,21,Branco,Heterossexual,Solteiro(a),Maceió,Sim,Universidade Federal de Alagoas,Graduação,2024
32195750-df63-11eb-bf23-972ef7bdc96c,1625689170370,1625690146146,stFemale,180,3.111111111,"3,2,3,4,3,3,2,4,4",3,2,3,4,3,3,2,4,4,"2, 5, 2, 3, 5, 5",2,5,2,3,5,5,1.00,2.33,"2,2,5,1,5,5,2,4,5,4,2,2,2,4,4,4,4",2,2,5,1,5,5,2,4,5,4,2,2,2,4,4,4,4,2,4,3.00,3.33,3.75,3.79,3.875,"4,3,4,5,5,3,3,4",4,3,4,5,5,3,3,4,inThreat,Masculino,19,Branco,Heterossexual,Solteiro(a),Maceió,Sim,UFAL,Graduação,2024
412915a0-df63-11eb-bf23-972ef7bdc96c,1625689223976,1625690027876,stFemale,200,3.111111111,"3,4,2,3,2,4,3,3,4",3,4,2,3,2,4,3,3,4,"4, 4, 4, 3, 5, 5",4,4,4,3,5,5,1.33,3.67,"2,3,1,1,2,5,6,7,5,6,1,1,1,6,7,7,6",2,3,1,1,2,5,6,7,5,6,1,1,1,6,7,7,6,1,6.5,1.25,2.33,6.00,2.17,4.25,"4,4,5,2,4,5,5,5",4,4,5,2,4,5,5,5,inThreat,Masculino,19,Branco,Heterossexual,Solteiro(a),Maceió,Sim,UFAL,Graduação,2024
d9957860-df63-11eb-bf23-972ef7bdc96c,1625689133155,1625690264637,default,160,2.666666667,"3,2,2,3,2,3,1,5,3",3,2,2,3,2,3,1,5,3,"3, 4, 2, 2, 4, 4",3,4,2,2,4,4,2.00,2.33,"4,3,6,3,5,5,3,5,3,4,4,5,3,4,4,4,3",4,3,6,3,5,5,3,5,3,4,4,5,3,4,4,4,3,4,3.75,4.13,4.33,3.75,4.29,3.25,"4,2,3,4,4,3,3,3",4,2,3,4,4,3,3,3,control,Masculino,23,Pardo,Bissexual,Solteiro(a),Marechal Deodoro,Sim,Ufal,Graduação,2023
3ee47f00-df72-11eb-bf23-972ef7bdc96c,1625695525960,1625696204660,stFemale,180,3.444444444,"4,2,4,2,4,3,4,5,3",4,2,4,2,4,3,4,5,3,"3, 5, 3, 3, 5, 4",3,5,3,3,5,4,1.33,3.00,"5,3,3,1,5,5,3,4,4,3,2,2,2,4,4,3,4",5,3,3,1,5,5,3,4,4,3,2,2,2,4,4,3,4,2,3.75,3.13,3.67,3.50,4.08,3.625,"4,4,3,4,3,3,3,5",4,4,3,4,3,3,3,5,inBoost,Feminino,21,Pardo,Heterossexual,Solteiro(a),Maceió,Sim,UFAL,Graduação,2024
8047d7e0-e656-11eb-aeff-859c71bd906c,1626454064062,1626454422716,stMale,190,3.333333333,"4,4,5,3,3,2,2,4,3",4,4,5,3,3,2,2,4,3,"2, 3, 3, 3, 5, 2",2,3,3,3,5,2,2.67,2.67,"4,5,5,1,1,4,4,6,6,3,1,1,1,6,5,5,5",4,5,5,1,1,4,4,6,6,3,1,1,1,6,5,5,5,1,5.25,1.88,3.33,4.75,3.29,4.625,"5,5,4,3,5,5,5,5",5,5,4,3,5,5,5,5,inBoost,Masculino,22,Pardo,Heterossexual,Solteiro(a),Limoeiro de Anadia,Sim,UFAL,Graduação,2023
4aee3340-e657-11eb-aeff-859c71bd906c,1626454027888,1626454699593,default,170,3,"3,3,2,2,5,3,2,5,2",3,3,2,2,5,3,2,5,2,"3, 4, 1, 1, 5, 1",3,4,1,1,5,1,2.67,1.67,"1,1,1,1,3,7,7,7,7,2,4,1,1,5,6,3,4",1,1,1,1,3,7,7,7,7,2,4,1,1,5,6,3,4,2,4.5,2.75,2.33,5.75,2.29,3.125,"5,1,3,3,4,3,3,3",5,1,3,3,4,3,3,3,control,Masculino,23,Branco,Heterossexual,Solteiro(a),Arapiraca,Sim,Ufal,Graduação,2022
2dbcb190-e682-11eb-aeff-859c71bd906c,1626472399273,1626473093231,default,170,2.444444444,"3,2,2,2,2,2,4,3,2",3,2,2,2,2,2,4,3,2,"2, 4, 3, 3, 5, 3",2,4,3,3,5,3,2.00,2.67,"3,5,5,2,6,3,4,5,5,3,2,2,2,5,4,5,4",3,5,5,2,6,3,4,5,5,3,2,2,2,5,4,5,4,2,4.5,2.75,4.00,4.25,3.88,4.375,"5,5,5,2,5,4,4,5",5,5,5,2,5,4,4,5,control,Masculino,21,Branco,Heterossexual,Solteiro(a),Arapiraca,Sim,UFAL,Graduação,2025
e6b9afe0-efb5-11eb-991d-7bf2f9a6c3b9,1627484618181,1627484929765,stFemale,150,3.777777778,"4,3,3,5,3,4,3,4,5",4,3,3,5,3,4,3,4,5,"3, 4, 4, 3, 4, 3",3,4,4,3,4,3,2.33,3.33,"1,1,1,1,2,2,6,6,4,,1,1,1,4,4,4,5",1,1,1,1,2,2,6,6,4,,1,1,1,4,4,4,5,1,4.25,2.38,1.33,5.33,2.00,3.75,"4,3,5,3,4,4,3,4",4,3,5,3,4,4,3,4,inThreat,Masculino,20,Pardo,Heterossexual,Solteiro(a),Arapiraca,Sim,UFAL,Graduação,2024
00b46200-efb6-11eb-991d-7bf2f9a6c3b9,1627484553211,1627484904155,default,110,3.444444444,"4,3,4,4,3,3,3,3,4",4,3,4,4,3,3,3,3,4,"3, 4, 3, 3, 4, 4",3,4,3,3,4,4,2.00,3.00,"3,3,2,1,3,1,7,4,5,7,1,1,1,4,5,5,6",3,3,2,1,3,1,7,4,5,7,1,1,1,4,5,5,6,1,5,2.00,2.17,5.75,2.21,3.125,"3,5,3,2,2,3,3,4",3,5,3,2,2,3,3,4,control,Masculino,25,Pardo,Heterossexual,Solteiro(a),Penedo,Sim,Universidade Federal de Alagoas,Graduação,2023
2d313ce0-efb6-11eb-991d-7bf2f9a6c3b9,1627484586441,1627485001456,stMale,150,3.666666667,"4,4,4,4,4,4,4,1,4",4,4,4,4,4,4,4,1,4,"4, 2, 5, 5, 2, 2",4,2,5,5,2,2,4.00,4.67,"3,2,2,2,6,2,6,2,6,6,2,2,2,4,4,4,4",3,2,2,2,6,2,6,2,6,6,2,2,2,4,4,4,4,2,4,3.00,2.83,5.00,2.92,3.375,"3,5,4,1,3,3,4,4",3,5,4,1,3,3,4,4,inThreat,Feminino,24,Branco,Bissexual,Solteiro(a),Maceió,Sim,UFAL,Graduação,2023
56024dd0-efb6-11eb-991d-7bf2f9a6c3b9,1627484536763,1627485096105,stMale,160,4,"4,4,5,5,4,3,2,5,4",4,4,5,5,4,3,2,5,4,"5, 4, 5, 5, 5, 4",5,4,5,5,5,4,1.67,5.00,"1,1,2,1,2,1,7,7,7,7,1,1,,6,5,5,6",1,1,2,1,2,1,7,7,7,7,1,1,,6,5,5,6,1,5.5,1.75,1.33,7.00,1.17,4.5,"5,5,5,2,5,5,4,5",5,5,5,2,5,5,4,5,inThreat,Feminino,23,Pardo,Heterossexual,Casado(a),Maceio,Sim,Ufal,Graduação,0
86f372c0-efb6-11eb-991d-7bf2f9a6c3b9,1627484572328,1627485050341,stMale,110,2.888888889,"3,1,3,4,3,3,2,4,3",3,1,3,4,3,3,2,4,3,"3, 5, 1, 1, 5, 3",3,5,1,1,5,3,1.67,1.67,"4,2,5,1,7,2,3,4,1,1,4,2,1,,1,1,1",4,2,5,1,7,2,3,4,1,1,4,2,1,,1,1,1,2.333333333,1,4.67,3.50,2.25,4.63,3.125,"3,5,2,3,5,2,1,4",3,5,2,3,5,2,1,4,inThreat,Feminino,21,Pardo,Bissexual,Solteiro(a),Maceió,Sim,UFAL,Graduação,2023
9dff1b40-efb6-11eb-991d-7bf2f9a6c3b9,1627484617000,1627485093751,default,110,2.777777778,"3,2,3,3,3,2,3,3,3",3,2,3,3,3,2,3,3,3,"2, 2, 3, 2, 3, 3",2,2,3,2,3,3,3.33,2.33,"3,3,6,2,6,6,2,3,1,3,4,4,4,5,4,3,3",3,3,6,2,6,6,2,3,1,3,4,4,4,5,4,3,3,4,3.75,4.13,4.33,2.25,5.04,2.25,"3,1,2,2,2,3,2,3",3,1,2,2,2,3,2,3,control,Feminino,22,Pardo,Heterossexual,Solteiro(a),Maceió-AL,Sim,Universidade Federal de Alagoas,Graduação,2023
d7092840-efb6-11eb-991d-7bf2f9a6c3b9,1627484824190,1627485311088,stMale,150,3.222222222,"4,4,2,3,2,2,5,5,2",4,4,2,3,2,2,5,5,2,"2, 3, 3, 2, 1, 1",2,3,3,2,1,1,4.33,2.33,"7,6,7,2,7,4,2,7,2,2,6,6,4,2,3,2,1",7,6,7,2,7,4,2,7,2,2,6,6,4,2,3,2,1,5.333333333,2,5.67,5.50,3.25,5.13,2.5,"2,3,3,5,1,2,1,3",2,3,3,5,1,2,1,3,inThreat,Feminino,19,Negro,Bissexual,Solteiro(a),Alagoas,Sim,ufal,Graduação,2023
ee21a200-efb6-11eb-991d-7bf2f9a6c3b9,1627484599157,1627485261850,default,130,2.666666667,"2,2,3,2,3,3,1,4,4",2,2,3,2,3,3,1,4,4,"3, 4, 3, 4, 5, 3",3,4,3,4,5,3,2.00,3.33,"4,2,5,2,7,6,2,4,2,2,4,6,3,2,2,1,2",4,2,5,2,7,6,2,4,2,2,4,6,3,2,2,1,2,4.333333333,1.75,5.29,4.33,2.50,4.92,2.625,"2,1,2,4,4,2,2,4",2,1,2,4,4,2,2,4,control,Feminino,20,Branco,Prefiro não Responder,Solteiro(a),Maceió,Sim,UFAL,Graduação,3
fdc45180-efb6-11eb-991d-7bf2f9a6c3b9,1627484632134,1627485310517,stFemale,150,3.444444444,"3,2,4,4,4,3,3,5,3",3,2,4,4,4,3,3,5,3,"3, 3, 3, 3, 5, 3",3,3,3,3,5,3,2.33,3.00,"4,3,3,1,5,2,3,4,5,5,3,3,2,4,4,3,5",4,3,3,1,5,2,3,4,5,5,3,3,2,4,4,3,5,2.666666667,4,3.33,3.00,4.25,3.38,4,"5,5,4,3,5,3,3,4",5,5,4,3,5,3,3,4,inBoost,Feminino,21,Branco,Heterossexual,Solteiro(a),Maceió,Sim,UFAL,Graduação,2024
084deb70-efb7-11eb-991d-7bf2f9a6c3b9,1627484631668,1627485351806,stFemale,150,3.111111111,"3,2,4,3,4,4,4,1,3",3,2,4,3,4,4,4,1,3,"2, 5, 4, 1, 4, 4",2,5,4,1,4,4,1.67,2.33,"1,1,1,1,1,1,6,6,6,6,3,3,1,4,4,4,6",1,1,1,1,1,1,6,6,6,6,3,3,1,4,4,4,6,2.333333333,4.5,2.92,1.00,6.00,1.50,3.625,"4,4,4,1,5,4,3,4",4,4,4,1,5,4,3,4,inThreat,Masculino,30,Pardo,Bissexual,Solteiro(a),Maceió,Sim,UFAL,Graduação,2024
17469f50-efb7-11eb-991d-7bf2f9a6c3b9,1627484632557,1627485400814,stMale,140,2.666666667,"3,2,3,3,3,2,1,4,3",3,2,3,3,3,2,1,4,3,"3, 5, 2, 2, 5, 5",3,5,2,2,5,5,1.00,2.33,"3,2,3,1,5,2,4,4,5,3,2,2,1,3,3,2,4",3,2,3,1,5,2,4,4,5,3,2,2,1,3,3,2,4,1.666666667,3,3.33,2.67,4.00,3.33,3,"4,3,3,2,4,3,2,3",4,3,3,2,4,3,2,3,inThreat,Feminino,20,Branco,Heterossexual,Solteiro(a),,Sim,UFAL,Graduação,
27025510-efb7-11eb-991d-7bf2f9a6c3b9,1627484550621,1627485385657,default,170,3.333333333,"3,3,4,3,3,3,4,4,3",3,3,4,3,3,3,4,4,3,"4, 2, 3, 3, 4, 2",4,2,3,3,4,2,3.33,3.33,"6,6,6,1,5,6,3,5,3,2,1,1,1,6,4,6,5",6,6,6,1,5,6,3,5,3,2,1,1,1,6,4,6,5,1,5.25,1.88,5.00,3.25,4.88,4,"4,5,4,3,4,4,3,5",4,5,4,3,4,4,3,5,control,Masculino,20,Branco,Heterossexual,Solteiro(a),Maceió,Sim,Universidade Federal de Alagoas,Graduação,2024
b42f8980-efb7-11eb-991d-7bf2f9a6c3b9,1627484809094,1627485542755,default,160,3,"4,3,4,2,2,2,3,4,3",4,3,4,2,2,2,3,4,3,"4, 2, 3, 2, 2, 2",4,2,3,2,2,2,4.00,3.00,"5,4,6,3,6,5,2,5,3,1,4,2,1,3,2,2,3",5,4,6,3,6,5,2,5,3,1,4,2,1,3,2,2,3,2.333333333,2.5,3.92,4.83,2.75,5.04,2.625,"2,2,2,5,3,2,1,4",2,2,2,5,3,2,1,4,control,Feminino,23,Branco,Pansexual,Solteiro(a),Maceió,Sim,UFAL,Graduação,2024
15067de0-efb8-11eb-991d-7bf2f9a6c3b9,1627484795648,1627485763133,default,140,3.333333333,"3,2,3,3,5,3,3,5,3",3,2,3,3,5,3,3,5,3,"3, 4, 3, 1, 5, 4",3,4,3,1,5,4,1.67,2.33,"3,1,1,1,7,1,5,5,5,4,5,5,1,1,1,1,3",3,1,1,1,7,1,5,5,5,4,5,5,1,1,1,1,3,3.666666667,1.5,5.08,2.33,4.75,2.79,2.5,"3,3,2,4,1,1,1,5",3,3,2,4,1,1,1,5,control,Feminino,19,Branco,Heterossexual,Solteiro(a),Maceió,Sim,ufal,Graduação,2023
37869fe0-f6e7-11eb-991d-7bf2f9a6c3b9,1628275209826,1628275738638,stFemale,130,3.555555556,"4,3,4,3,3,3,4,5,3",4,3,4,3,3,3,4,5,3,"3, 5, 4, 4, 4, 4",3,5,4,4,4,4,1.67,3.67,"2,3,5,1,4,1,7,5,4,7,1,1,1,4,4,4,4",2,3,5,1,4,1,7,5,4,7,1,1,1,4,4,4,4,1,4,2.50,2.67,5.75,2.46,3.5,"3,2,5,5,4,3,3,3",3,2,5,5,4,3,3,3,inBoost,Feminino,35,Branco,Heterossexual,Casado(a),Maceió,Sim,UFAL,Graduação,2023
5ad35650-f6e7-11eb-991d-7bf2f9a6c3b9,1628275217396,1628275734261,default,100,2.888888889,"3,1,3,3,3,3,4,3,3",3,1,3,3,3,3,4,3,3,"2, 4, 3, 2, 5, 2",2,4,3,2,5,2,2.33,2.33,"2,1,2,2,3,2,2,3,2,1,2,2,1,3,3,2,3",2,1,2,2,3,2,2,3,2,1,2,2,1,3,3,2,3,1.666666667,2.75,3.46,2.00,2.00,4.00,3.5,"4,3,3,3,4,4,3,4",4,3,3,3,4,4,3,4,control,Feminino,22,Negro,Heterossexual,Solteiro(a),Maceió,Sim,UFAL,Graduação,3
670fa950-f6e7-11eb-991d-7bf2f9a6c3b9,1628275270435,1628275791276,stFemale,140,3.222222222,"5,3,4,3,2,2,1,5,4",5,3,4,3,2,2,1,5,4,"1, 1, 4, 1, 3, 1",1,1,4,1,3,1,4.33,2.00,"5,6,6,5,5,6,2,3,4,2,6,6,4,1,2,1,5",5,6,6,5,5,6,2,3,4,2,6,6,4,1,2,1,5,5.333333333,2.25,5.54,5.50,2.75,5.38,2,"5,2,1,4,1,1,1,1",5,2,1,4,1,1,1,1,inBoost,Feminino,19,Pardo,Heterossexual,Solteiro(a),Maceió,Sim,UFAL,Graduação,2015
a59955e0-f6e7-11eb-991d-7bf2f9a6c3b9,1628275285186,1628275891680,stFemale,160,3.333333333,"2,2,4,3,3,3,4,4,5",2,2,4,3,3,3,4,4,5,"4, 5, 4, 4, 4, 3",4,5,4,4,4,3,2.00,4.00,"1,1,2,1,6,1,7,5,7,7,2,2,1,6,6,6,6",1,1,2,1,6,1,7,5,7,7,2,2,1,6,6,6,6,1.666666667,6,1.83,2.00,6.50,1.75,4.375,"5,5,4,3,5,4,4,5",5,5,4,3,5,4,4,5,inBoost,Feminino,20,Pardo,Homossexual,Solteiro(a),Rio Largo,Sim,UFAL,Graduação,2022
f8b19d00-f6e7-11eb-991d-7bf2f9a6c3b9,1628275372963,1628276020185,stFemale,110,3.333333333,"5,1,5,1,5,3,2,5,3",5,1,5,1,5,3,2,5,3,"4, 5, 1, 5, 5, 5",4,5,1,5,5,5,1.00,3.33,"2,2,3,1,4,1,4,4,4,4,1,1,1,5,5,5,5",2,2,3,1,4,1,4,4,4,4,1,1,1,5,5,5,5,1,5,2.00,2.17,4.00,3.08,3.125,"2,2,4,5,3,3,3,3",2,2,4,5,3,3,3,3,inBoost,Feminino,20,Branco,Heterossexual,Solteiro(a),Rio Largo,Sim,Ufal,Graduação,2023
175e8c90-f6e8-11eb-991d-7bf2f9a6c3b9,1628275231812,1628276109771,stFemale,170,3.666666667,"4,3,4,4,4,3,3,3,5",4,3,4,4,4,3,3,3,5,"4, 5, 5, 5, 5, 5",4,5,5,5,5,5,1.00,4.67,"7,4,3,1,2,2,3,3,3,3,4,3,3,3,4,4,4",7,4,3,1,2,2,3,3,3,3,4,3,3,3,4,4,4,3.333333333,3.75,3.79,3.17,3.00,4.08,2.5,"3,3,3,3,3,1,1,3",3,3,3,3,3,1,1,3,inBoost,Feminino,22,Branco,Heterossexual,Solteiro(a),Maceió,Sim,Ufal,Graduação,2023
48089660-f6e8-11eb-991d-7bf2f9a6c3b9,1628275356422,1628276180800,stFemale,160,2.888888889,"3,3,2,3,3,3,2,4,3",3,3,2,3,3,3,2,4,3,"3, 5, 4, 5, 5, 5",3,5,4,5,5,5,1.00,4.00,"5,1,5,1,5,5,2,5,1,3,1,1,1,6,5,6,3",5,1,5,1,5,5,2,5,1,3,1,1,1,6,5,6,3,1,5,2.00,3.67,2.75,4.46,4.375,"4,5,5,5,4,3,5,4",4,5,5,5,4,3,5,4,inBoost,Feminino,20,Branco,Heterossexual,Solteiro(a),Maceió,Sim,Ufal,Graduação,2023
9d1ee580-f6ea-11eb-991d-7bf2f9a6c3b9,1628276094117,1628277093893,default,160,3.666666667,"5,3,4,3,4,3,3,4,4",5,3,4,3,4,3,3,4,4,"3, 3, 4, 3, 4, 5",3,3,4,3,4,5,2.00,3.33,"5,1,3,1,2,1,2,6,2,2,1,1,1,6,6,6,6",5,1,3,1,2,1,2,6,2,2,1,1,1,6,6,6,6,1,6,1.50,2.17,3.00,3.58,4.125,"5,4,4,4,4,4,4,4",5,4,4,4,4,4,4,4,control,Masculino,22,Pardo,Heterossexual,Solteiro(a),ATALAIA,Sim,UFAL,Outros,2022